salary_id,employee_id,month,base_salary,bonus,total_salary
1,1,2024-01-01,43550,1463,45013
2,2,2024-01-01,21303,1243,22546
3,3,2024-01-01,41436,4130,45566
4,4,2024-01-01,46021,2666,48687
5,5,2024-01-01,43455,1030,44485
6,6,2024-01-01,28377,3194,31571
7,7,2024-01-01,46933,3116,50049
8,8,2024-01-01,39236,2736,41972
9,9,2024-01-01,30833,280,31113
10,10,2024-01-01,49363,2186,51549
11,11,2024-01-01,44213,509,44722
12,12,2024-01-01,49014,4403,53417
13,13,2024-01-01,23991,4180,28171
14,14,2024-01-01,42065,3287,45352
15,15,2024-01-01,33979,1872,35851
16,16,2024-01-01,28246,2462,30708
17,17,2024-01-01,43643,4051,47694
18,18,2024-01-01,42572,4949,47521
19,19,2024-01-01,35579,4597,40176
20,20,2024-01-01,25091,3736,28827
21,21,2024-01-01,27536,3451,30987
22,22,2024-01-01,25634,2655,28289
23,23,2024-01-01,25561,2867,28428
24,24,2024-01-01,28985,3281,32266
25,25,2024-01-01,40814,2221,43035
26,26,2024-01-01,28558,995,29553
27,27,2024-01-01,12793,1195,13988
28,28,2024-01-01,27251,3156,30407
29,29,2024-01-01,0,2979,2979
30,30,2024-01-01,45309,3146,48455
31,31,2024-01-01,38837,3678,42515
32,32,2024-01-01,33668,-220,33448
33,33,2024-01-01,32475,3264,35739
34,34,2024-01-01,39933,2752,42685
35,35,2024-01-01,10918,2923,13841
36,36,2024-01-01,40842,564,41406
37,37,2024-01-01,49401,1702,51103
38,38,2024-01-01,34120,2052,36172
39,39,2024-01-01,46034,3688,49722
40,40,2024-01-01,17533,758,18291
41,41,2024-01-01,13287,1087,14374
42,42,2024-01-01,37240,3525,40765
43,43,2024-01-01,43104,4171,47275
44,44,2024-01-01,10146,2593,12739
45,45,2024-01-01,18880,4087,22967
46,46,2024-01-01,15599,4980,20579
47,47,2024-01-01,37656,-4734,32922
48,48,2024-01-01,10168,2936,13104
49,49,2024-01-01,19073,3391,22464
50,50,2024-01-01,16565,1765,18330
51,51,2024-01-01,48290,986,49276
52,52,2024-01-01,46048,1708,47756
53,53,2024-01-01,31491,1564,33055
54,54,2024-01-01,19138,3471,22609
55,55,2024-01-01,44736,3360,48096
56,56,2024-01-01,14080,2308,16388
57,57,2024-01-01,46451,2556,49007
58,58,2024-01-01,30407,3288,33695
59,59,2024-01-01,33673,-774,32899
60,60,2024-01-01,46121,1636,47757
61,61,2024-01-01,15396,2570,17966
62,62,2024-01-01,44075,4501,48576
63,63,2024-01-01,43290,3386,46676
64,64,2024-01-01,27293,2121,29414
65,65,2024-01-01,18100,924,19024
66,66,2024-01-01,36853,575,37428
67,67,2024-01-01,11121,3154,14275
68,68,2024-01-01,23774,1704,25478
69,69,2024-01-01,32022,286,32308
70,70,2024-01-01,11099,1345,12444
71,71,2024-01-01,39276,3440,42716
72,72,2024-01-01,42231,2721,44952
73,73,2024-01-01,34296,4757,39053
74,74,2024-01-01,39123,3334,42457
75,75,2024-01-01,16217,2669,18886
76,76,2024-01-01,37821,89,37910
77,77,2024-01-01,32490,363,32853
78,78,2024-01-01,40925,415,41340
79,79,2024-01-01,13272,4655,17927
80,80,2024-01-01,23814,1904,25718
81,81,2024-01-01,22998,3795,26793
82,82,2024-01-01,23009,2853,25862
83,83,2024-01-01,40060,922,40982
84,84,2024-01-01,43792,1561,45353
85,85,2024-01-01,16944,2050,18994
86,86,2024-01-01,36595,447,37042
87,87,2024-01-01,17039,580,17619
88,88,2024-01-01,43741,2469,46210
89,89,2024-01-01,46379,4455,50834
90,90,2024-01-01,26250,128,26378
91,91,2024-01-01,46200,2243,48443
92,92,2024-01-01,20326,913,21239
93,93,2024-01-01,12538,4363,16901
94,94,2024-01-01,15137,2841,17978
95,95,2024-01-01,19329,3190,22519
96,96,2024-01-01,28954,2034,30988
97,97,2024-01-01,27809,4856,32665
98,98,2024-01-01,24134,4056,28190
99,99,2024-01-01,32694,4593,37287
100,100,2024-01-01,40071,3385,43456
101,101,2024-01-01,18463,366,18829
102,102,2024-01-01,15305,4690,19995
103,103,2024-01-01,38516,1286,39802
104,104,2024-01-01,18533,2393,20926
105,105,2024-01-01,46697,2372,49069
106,106,2024-01-01,41602,4445,46047
107,107,2024-01-01,22976,4733,27709
108,108,2024-01-01,45888,545,46433
109,109,2024-01-01,45314,2891,48205
110,110,2024-01-01,27311,4661,31972
111,111,2024-01-01,23754,-1110,22644
112,112,2024-01-01,11825,2914,14739
113,113,2024-01-01,45667,473,46140
114,114,2024-01-01,18812,1359,20171
115,115,2024-01-01,41887,5,41892
116,116,2024-01-01,19898,2816,22714
117,117,2024-01-01,36648,4064,40712
118,118,2024-01-01,34729,715,35444
119,119,2024-01-01,25510,308,25818
120,120,2024-01-01,17981,3998,21979
121,121,2024-01-01,36637,3198,39835
122,122,2024-01-01,18493,1416,19909
123,123,2024-01-01,35721,2455,38176
124,124,2024-01-01,34794,1027,35821
125,125,2024-01-01,34562,2510,37072
126,126,2024-01-01,22219,2148,24367
127,127,2024-01-01,21889,2689,24578
128,128,2024-01-01,29447,-4325,25122
129,129,2024-01-01,36131,1876,38007
130,130,2024-01-01,24616,3452,28068
131,131,2024-01-01,44647,2785,47432
132,132,2024-01-01,41725,2456,44181
133,133,2024-01-01,16425,222,16647
134,134,2024-01-01,48962,3835,52797
135,135,2024-01-01,18983,3544,22527
136,136,2024-01-01,35082,189,35271
137,137,2024-01-01,38809,460,39269
138,138,2024-01-01,16405,2735,19140
139,139,2024-01-01,29132,1149,30281
140,140,2024-01-01,23447,2526,25973
141,141,2024-01-01,40613,-1808,38805
142,142,2024-01-01,16298,893,17191
143,143,2024-01-01,32996,2334,35330
144,144,2024-01-01,40069,1819,41888
145,145,2024-01-01,38680,3692,42372
146,146,2024-01-01,10129,-2422,7707
147,147,2024-01-01,49157,4832,53989
148,148,2024-01-01,35668,4563,40231
149,149,2024-01-01,33480,5,33485
150,150,2024-01-01,49835,4275,54110
151,151,2024-01-01,20407,1334,21741
152,152,2024-01-01,42800,1099,43899
153,153,2024-01-01,33508,117,33625
154,154,2024-01-01,42443,1402,43845
155,155,2024-01-01,18019,2109,20128
156,156,2024-01-01,15914,4059,19973
157,157,2024-01-01,40282,4724,45006
158,158,2024-01-01,11929,1783,13712
159,159,2024-01-01,36684,326,37010
160,160,2024-01-01,47559,-1005,46554
161,161,2024-01-01,34032,1043,35075
162,162,2024-01-01,24042,4716,28758
163,163,2024-01-01,29548,4974,34522
164,164,2024-01-01,30928,4913,35841
165,165,2024-01-01,37539,1234,38773
166,166,2024-01-01,20393,2769,23162
167,167,2024-01-01,48068,3085,51153
168,168,2024-01-01,46100,390,46490
169,169,2024-01-01,11722,4098,15820
170,170,2024-01-01,21148,621,21769
171,171,2024-01-01,27462,453,27915
172,172,2024-01-01,46802,2221,49023
173,173,2024-01-01,46612,4630,51242
174,174,2024-01-01,10392,1005,11397
175,175,2024-01-01,16187,4554,20741
176,176,2024-01-01,48608,2654,51262
177,177,2024-01-01,30150,2905,33055
178,178,2024-01-01,0,4470,4470
179,179,2024-01-01,40629,3646,44275
180,180,2024-01-01,17043,2660,19703
181,181,2024-01-01,0,2442,2442
182,182,2024-01-01,17118,881,17999
183,183,2024-01-01,28179,1852,30031
184,184,2024-01-01,44890,4883,49773
185,185,2024-01-01,26397,770,27167
186,186,2024-01-01,28570,4123,32693
187,187,2024-01-01,45863,582,46445
188,188,2024-01-01,16359,1048,17407
189,189,2024-01-01,43618,1058,44676
190,190,2024-01-01,44797,777,45574
191,191,2024-01-01,33951,1755,35706
192,192,2024-01-01,38907,4425,43332
193,193,2024-01-01,45754,3614,49368
194,194,2024-01-01,37902,2750,40652
195,195,2024-01-01,21962,1174,23136
196,196,2024-01-01,19691,1559,21250
197,197,2024-01-01,36711,1929,38640
198,198,2024-01-01,25213,4188,29401
199,199,2024-01-01,19328,3774,23102
200,200,2024-01-01,41580,1342,42922
201,201,2024-01-01,16516,730,17246
202,202,2024-01-01,39440,1804,41244
203,203,2024-01-01,15056,3542,18598
204,204,2024-01-01,25323,4146,29469
205,205,2024-01-01,45655,3277,48932
206,206,2024-01-01,33369,4215,37584
207,207,2024-01-01,48424,1892,50316
208,208,2024-01-01,33877,1185,35062
209,209,2024-01-01,44110,3190,47300
210,210,2024-01-01,45580,1553,47133
211,211,2024-01-01,40602,648,41250
212,212,2024-01-01,13969,4915,18884
213,213,2024-01-01,25142,3606,28748
214,214,2024-01-01,38491,1741,40232
215,215,2024-01-01,29266,600,29866
216,216,2024-01-01,21900,2944,24844
217,217,2024-01-01,32764,1407,34171
218,218,2024-01-01,37833,4025,41858
219,219,2024-01-01,31421,549,31970
220,220,2024-01-01,49243,3869,53112
221,221,2024-01-01,42468,4980,47448
222,222,2024-01-01,18875,3508,22383
223,223,2024-01-01,35332,1951,37283
224,224,2024-01-01,34603,193,34796
225,225,2024-01-01,28703,2851,31554
226,226,2024-01-01,44721,-4614,40107
227,227,2024-01-01,15182,401,15583
228,228,2024-01-01,0,2039,2039
229,229,2024-01-01,39647,1674,41321
230,230,2024-01-01,14054,3922,17976
231,231,2024-01-01,12461,4826,17287
232,232,2024-01-01,22813,2303,25116
233,233,2024-01-01,32641,2419,35060
234,234,2024-01-01,23296,3391,26687
235,235,2024-01-01,19947,-1710,18237
236,236,2024-01-01,38208,4562,42770
237,237,2024-01-01,41867,-2944,38923
238,238,2024-01-01,37912,4687,42599
239,239,2024-01-01,36557,2729,39286
240,240,2024-01-01,13414,254,13668
241,241,2024-01-01,32582,4126,36708
242,242,2024-01-01,48975,3555,52530
243,243,2024-01-01,12951,3347,16298
244,244,2024-01-01,28907,4385,33292
245,245,2024-01-01,45366,2995,48361
246,246,2024-01-01,13038,4420,17458
247,247,2024-01-01,38250,3224,41474
248,248,2024-01-01,46839,983,47822
249,249,2024-01-01,49169,4366,53535
250,250,2024-01-01,42976,4075,47051
251,251,2024-01-01,14293,735,15028
252,252,2024-01-01,41339,-2658,38681
253,253,2024-01-01,11414,351,11765
254,254,2024-01-01,35072,4157,39229
255,255,2024-01-01,47901,501,48402
256,256,2024-01-01,28760,4448,33208
257,257,2024-01-01,34283,1677,35960
258,258,2024-01-01,22781,771,23552
259,259,2024-01-01,10688,507,11195
260,260,2024-01-01,36197,4148,40345
261,261,2024-01-01,31107,3067,34174
262,262,2024-01-01,27897,3314,31211
263,263,2024-01-01,34468,472,34940
264,264,2024-01-01,15942,3264,19206
265,265,2024-01-01,19712,3122,22834
266,266,2024-01-01,11173,1991,13164
267,267,2024-01-01,41489,2972,44461
268,268,2024-01-01,47494,2440,49934
269,269,2024-01-01,46423,4637,51060
270,270,2024-01-01,47030,527,47557
271,271,2024-01-01,14457,485,14942
272,272,2024-01-01,28336,2958,31294
273,273,2024-01-01,44984,2833,47817
274,274,2024-01-01,28126,1244,29370
275,275,2024-01-01,31813,3254,35067
276,276,2024-01-01,11970,2930,14900
277,277,2024-01-01,30965,4627,35592
278,278,2024-01-01,44699,1938,46637
279,279,2024-01-01,41142,88,41230
280,280,2024-01-01,13703,2305,16008
281,281,2024-01-01,28281,-2267,26014
282,282,2024-01-01,29818,1463,31281
283,283,2024-01-01,42954,3651,46605
284,284,2024-01-01,34723,2392,37115
285,285,2024-01-01,26984,1706,28690
286,286,2024-01-01,48584,3271,51855
287,287,2024-01-01,35580,565,36145
288,288,2024-01-01,10641,-4742,5899
289,289,2024-01-01,17387,4784,22171
290,290,2024-01-01,19036,3213,22249
291,291,2024-01-01,38869,4794,43663
292,292,2024-01-01,11933,1849,13782
293,293,2024-01-01,25404,2897,28301
294,294,2024-01-01,33383,2208,35591
295,295,2024-01-01,42168,3348,45516
296,296,2024-01-01,10118,3827,13945
297,297,2024-01-01,40218,4553,44771
298,298,2024-01-01,22495,4377,26872
299,299,2024-01-01,15884,1541,17425
300,300,2024-01-01,28369,-2751,25618
301,301,2024-01-01,19890,2549,22439
302,302,2024-01-01,18603,4977,23580
303,303,2024-01-01,27792,4433,32225
304,304,2024-01-01,40735,271,41006
305,305,2024-01-01,26834,2113,28947
306,306,2024-01-01,39951,1201,41152
307,307,2024-01-01,41784,2331,44115
308,308,2024-01-01,22329,1289,23618
309,309,2024-01-01,20398,3434,23832
310,310,2024-01-01,37037,884,37921
311,311,2024-01-01,29570,1865,31435
312,312,2024-01-01,24540,3095,27635
313,313,2024-01-01,38409,782,39191
314,314,2024-01-01,12560,4490,17050
315,315,2024-01-01,46687,2493,49180
316,316,2024-01-01,36523,3642,40165
317,317,2024-01-01,37892,4102,41994
318,318,2024-01-01,37933,1984,39917
319,319,2024-01-01,41632,4220,45852
320,320,2024-01-01,22989,1728,24717
321,321,2024-01-01,19380,3295,22675
322,322,2024-01-01,19645,1535,21180
323,323,2024-01-01,47779,4319,52098
324,324,2024-01-01,20526,4647,25173
325,325,2024-01-01,39784,3002,42786
326,326,2024-01-01,28428,3116,31544
327,327,2024-01-01,34301,3447,37748
328,328,2024-01-01,18388,1454,19842
329,329,2024-01-01,34984,2031,37015
330,330,2024-01-01,49422,1104,50526
331,331,2024-01-01,20880,-516,20364
332,332,2024-01-01,34129,4400,38529
333,333,2024-01-01,42444,4125,46569
334,334,2024-01-01,48996,3297,52293
335,335,2024-01-01,37299,3987,41286
336,336,2024-01-01,43629,3662,47291
337,337,2024-01-01,28171,3425,31596
338,338,2024-01-01,49862,4892,54754
339,339,2024-01-01,30137,1408,31545
340,340,2024-01-01,24386,13,24399
341,341,2024-01-01,47188,2035,49223
342,342,2024-01-01,38937,-10,38927
343,343,2024-01-01,10661,677,11338
344,344,2024-01-01,46380,1152,47532
345,345,2024-01-01,22713,1476,24189
346,346,2024-01-01,37594,3165,40759
347,347,2024-01-01,43295,292,43587
348,348,2024-01-01,10853,1361,12214
349,349,2024-01-01,29855,4134,33989
350,350,2024-01-01,29121,2978,32099
351,351,2024-01-01,20732,2123,22855
352,352,2024-01-01,26164,4965,31129
353,353,2024-01-01,13201,1954,15155
354,354,2024-01-01,47210,464,47674
355,355,2024-01-01,46350,2070,48420
356,356,2024-01-01,22368,4585,26953
357,357,2024-01-01,48456,2867,51323
358,358,2024-01-01,49713,4761,54474
359,359,2024-01-01,39492,2260,41752
360,360,2024-01-01,34152,383,34535
361,361,2024-01-01,18053,-1436,16617
362,362,2024-01-01,40307,1773,42080
363,363,2024-01-01,26265,4690,30955
364,364,2024-01-01,12890,1111,14001
365,365,2024-01-01,17723,1072,18795
366,366,2024-01-01,39636,3359,42995
367,367,2024-01-01,43203,1350,44553
368,368,2024-01-01,18136,2574,20710
369,369,2024-01-01,44228,4887,49115
370,370,2024-01-01,29066,2791,31857
371,371,2024-01-01,41738,851,42589
372,372,2024-01-01,20779,1252,22031
373,373,2024-01-01,19795,2242,22037
374,374,2024-01-01,16934,1886,18820
375,375,2024-01-01,27285,4630,31915
376,376,2024-01-01,42577,2276,44853
377,377,2024-01-01,25282,232,25514
378,378,2024-01-01,17039,1403,18442
379,379,2024-01-01,32224,1442,33666
380,380,2024-01-01,21085,2193,23278
381,381,2024-01-01,45458,4070,49528
382,382,2024-01-01,30594,4409,35003
383,383,2024-01-01,36551,927,37478
384,384,2024-01-01,40683,4898,45581
385,385,2024-01-01,36693,2839,39532
386,386,2024-01-01,27693,2914,30607
387,387,2024-01-01,30779,-2690,28089
388,388,2024-01-01,29263,2603,31866
389,389,2024-01-01,11590,4993,16583
390,390,2024-01-01,20100,2118,22218
391,391,2024-01-01,46122,962,47084
392,392,2024-01-01,44764,2829,47593
393,393,2024-01-01,18349,-75,18274
394,394,2024-01-01,20102,844,20946
395,395,2024-01-01,48974,1480,50454
396,396,2024-01-01,48481,2090,50571
397,397,2024-01-01,20320,4378,24698
398,398,2024-01-01,20909,3619,24528
399,399,2024-01-01,40292,4912,45204
400,400,2024-01-01,19002,2090,21092
401,401,2024-01-01,21206,3817,25023
402,402,2024-01-01,45349,4978,50327
403,403,2024-01-01,35889,4827,40716
404,404,2024-01-01,16961,530,17491
405,405,2024-01-01,11079,1170,12249
406,406,2024-01-01,36206,1462,37668
407,407,2024-01-01,41445,702,42147
408,408,2024-01-01,49331,576,49907
409,409,2024-01-01,47623,2418,50041
410,410,2024-01-01,33708,1582,35290
411,411,2024-01-01,48712,2336,51048
412,412,2024-01-01,18400,3739,22139
413,413,2024-01-01,44067,3346,47413
414,414,2024-01-01,28862,1679,30541
415,415,2024-01-01,28332,4283,32615
416,416,2024-01-01,15370,1249,16619
417,417,2024-01-01,45732,3403,49135
418,418,2024-01-01,33110,3851,36961
419,419,2024-01-01,17597,4024,21621
420,420,2024-01-01,13301,1533,14834
421,421,2024-01-01,24687,2939,27626
422,422,2024-01-01,34183,1088,35271
423,423,2024-01-01,35053,4853,39906
424,424,2024-01-01,22427,4016,26443
425,425,2024-01-01,37354,1275,38629
426,426,2024-01-01,13360,1040,14400
427,427,2024-01-01,45923,953,46876
428,428,2024-01-01,47047,1129,48176
429,429,2024-01-01,12386,3325,15711
430,430,2024-01-01,40195,3223,43418
431,431,2024-01-01,36546,1372,37918
432,432,2024-01-01,13712,3182,16894
433,433,2024-01-01,19586,-4898,14688
434,434,2024-01-01,46066,2979,49045
435,435,2024-01-01,15555,-419,15136
436,436,2024-01-01,32083,2751,34834
437,437,2024-01-01,48370,3654,52024
438,438,2024-01-01,19082,4278,23360
439,439,2024-01-01,12992,4915,17907
440,440,2024-01-01,12310,1559,13869
441,441,2024-01-01,32278,2749,35027
442,442,2024-01-01,32504,3267,35771
443,443,2024-01-01,38387,759,39146
444,444,2024-01-01,33116,2404,35520
445,445,2024-01-01,24503,1027,25530
446,446,2024-01-01,37641,83,37724
447,447,2024-01-01,15130,4447,19577
448,448,2024-01-01,0,563,563
449,449,2024-01-01,12140,822,12962
450,450,2024-01-01,38332,4223,42555
451,451,2024-01-01,38594,3219,41813
452,452,2024-01-01,46725,1489,48214
453,453,2024-01-01,24438,4940,29378
454,454,2024-01-01,11934,2771,14705
455,455,2024-01-01,34205,1465,35670
456,456,2024-01-01,19496,4960,24456
457,457,2024-01-01,15215,4018,19233
458,458,2024-01-01,22481,-4757,17724
459,459,2024-01-01,16101,2000,18101
460,460,2024-01-01,26553,199,26752
461,461,2024-01-01,15601,1693,17294
462,462,2024-01-01,42408,4713,47121
463,463,2024-01-01,47567,1334,48901
464,464,2024-01-01,35709,1442,37151
465,465,2024-01-01,25429,198,25627
466,466,2024-01-01,47940,2729,50669
467,467,2024-01-01,45156,751,45907
468,468,2024-01-01,16524,2586,19110
469,469,2024-01-01,25464,3368,28832
470,470,2024-01-01,0,-600,-600
471,471,2024-01-01,40176,2776,42952
472,472,2024-01-01,49857,2691,52548
473,473,2024-01-01,40313,512,40825
474,474,2024-01-01,29918,2418,32336
475,475,2024-01-01,10699,737,11436
476,476,2024-01-01,30153,407,30560
477,477,2024-01-01,42268,896,43164
478,478,2024-01-01,39678,4329,44007
479,479,2024-01-01,45602,-1438,44164
480,480,2024-01-01,13181,540,13721
481,481,2024-01-01,21007,845,21852
482,482,2024-01-01,24254,2254,26508
483,483,2024-01-01,29719,4792,34511
484,484,2024-01-01,21777,1239,23016
485,485,2024-01-01,11274,1719,12993
486,486,2024-01-01,49342,783,50125
487,487,2024-01-01,40285,2539,42824
488,488,2024-01-01,24395,4455,28850
489,489,2024-01-01,46861,1693,48554
490,490,2024-01-01,38585,2823,41408
491,491,2024-01-01,32828,1051,33879
492,492,2024-01-01,38616,1523,40139
493,493,2024-01-01,36456,3581,40037
494,494,2024-01-01,12670,1338,14008
495,495,2024-01-01,42959,4127,47086
496,496,2024-01-01,14965,2181,17146
497,497,2024-01-01,32720,273,32993
498,498,2024-01-01,19849,3963,23812
499,499,2024-01-01,41928,64,41992
500,500,2024-01-01,36578,4958,41536
501,1,2024-02-01,46265,3811,50076
502,2,2024-02-01,48189,4732,52921
503,3,2024-02-01,17171,1572,18743
504,4,2024-02-01,24256,4121,28377
505,5,2024-02-01,0,3155,3155
506,6,2024-02-01,28410,1131,29541
507,7,2024-02-01,24670,1900,26570
508,8,2024-02-01,38458,244,38702
509,9,2024-02-01,30000,4113,34113
510,10,2024-02-01,22642,481,23123
511,11,2024-02-01,47766,1240,49006
512,12,2024-02-01,35167,1058,36225
513,13,2024-02-01,36284,2157,38441
514,14,2024-02-01,34982,993,35975
515,15,2024-02-01,10092,3292,13384
516,16,2024-02-01,48148,743,48891
517,17,2024-02-01,38597,2714,41311
518,18,2024-02-01,12771,2395,15166
519,19,2024-02-01,47244,833,48077
520,20,2024-02-01,28946,3934,32880
521,21,2024-02-01,43594,3314,46908
522,22,2024-02-01,26889,2502,29391
523,23,2024-02-01,30629,4261,34890
524,24,2024-02-01,22506,4395,26901
525,25,2024-02-01,36322,3219,39541
526,26,2024-02-01,40506,1246,41752
527,27,2024-02-01,13791,4696,18487
528,28,2024-02-01,30805,2057,32862
529,29,2024-02-01,22659,4171,26830
530,30,2024-02-01,45685,387,46072
531,31,2024-02-01,25528,1007,26535
532,32,2024-02-01,28149,945,29094
533,33,2024-02-01,16396,3311,19707
534,34,2024-02-01,27762,1691,29453
535,35,2024-02-01,15858,2219,18077
536,36,2024-02-01,24741,1182,25923
537,37,2024-02-01,45810,3386,49196
538,38,2024-02-01,18591,3653,22244
539,39,2024-02-01,25444,2347,27791
540,40,2024-02-01,15788,1496,17284
541,41,2024-02-01,24476,2089,26565
542,42,2024-02-01,30254,4560,34814
543,43,2024-02-01,18917,1636,20553
544,44,2024-02-01,12512,403,12915
545,45,2024-02-01,45301,4229,49530
546,46,2024-02-01,26359,4646,31005
547,47,2024-02-01,34859,3349,38208
548,48,2024-02-01,13843,3263,17106
549,49,2024-02-01,28334,4565,32899
550,50,2024-02-01,34823,531,35354
551,51,2024-02-01,19845,2548,22393
552,52,2024-02-01,32382,2092,34474
553,53,2024-02-01,15980,3700,19680
554,54,2024-02-01,47265,537,47802
555,55,2024-02-01,46850,2347,49197
556,56,2024-02-01,46052,-1302,44750
557,57,2024-02-01,14274,1978,16252
558,58,2024-02-01,42601,1197,43798
559,59,2024-02-01,42200,2552,44752
560,60,2024-02-01,26423,504,26927
561,61,2024-02-01,24946,3795,28741
562,62,2024-02-01,20148,4436,24584
563,63,2024-02-01,32696,3847,36543
564,64,2024-02-01,18190,2804,20994
565,65,2024-02-01,11468,3116,14584
566,66,2024-02-01,31014,4366,35380
567,67,2024-02-01,20311,3860,24171
568,68,2024-02-01,48035,3334,51369
569,69,2024-02-01,0,4577,4577
570,70,2024-02-01,32758,3074,35832
571,71,2024-02-01,18516,275,18791
572,72,2024-02-01,33120,1062,34182
573,73,2024-02-01,10934,2728,13662
574,74,2024-02-01,11060,4127,15187
575,75,2024-02-01,17013,3283,20296
576,76,2024-02-01,23358,1712,25070
577,77,2024-02-01,31422,90,31512
578,78,2024-02-01,36013,1507,37520
579,79,2024-02-01,27503,3309,30812
580,80,2024-02-01,41996,2965,44961
581,81,2024-02-01,14822,4051,18873
582,82,2024-02-01,45388,1270,46658
583,83,2024-02-01,19245,2790,22035
584,84,2024-02-01,13205,4915,18120
585,85,2024-02-01,48595,2187,50782
586,86,2024-02-01,28584,4972,33556
587,87,2024-02-01,12491,513,13004
588,88,2024-02-01,37473,1951,39424
589,89,2024-02-01,24572,639,25211
590,90,2024-02-01,30742,1562,32304
591,91,2024-02-01,32573,4746,37319
592,92,2024-02-01,31467,4465,35932
593,93,2024-02-01,39658,4951,44609
594,94,2024-02-01,13201,4841,18042
595,95,2024-02-01,32763,4881,37644
596,96,2024-02-01,28436,1534,29970
597,97,2024-02-01,34882,285,35167
598,98,2024-02-01,43069,254,43323
599,99,2024-02-01,18404,2787,21191
600,100,2024-02-01,48912,1105,50017
601,101,2024-02-01,23810,2050,25860
602,102,2024-02-01,19033,-3528,15505
603,103,2024-02-01,44296,2025,46321
604,104,2024-02-01,33687,4045,37732
605,105,2024-02-01,36510,2886,39396
606,106,2024-02-01,15960,1393,17353
607,107,2024-02-01,48179,2583,50762
608,108,2024-02-01,36769,2756,39525
609,109,2024-02-01,35064,2778,37842
610,110,2024-02-01,32022,425,32447
611,111,2024-02-01,25617,174,25791
612,112,2024-02-01,38019,117,38136
613,113,2024-02-01,28706,2735,31441
614,114,2024-02-01,20892,3256,24148
615,115,2024-02-01,12676,3318,15994
616,116,2024-02-01,18100,2915,21015
617,117,2024-02-01,32957,1505,34462
618,118,2024-02-01,23867,3337,27204
619,119,2024-02-01,13736,1455,15191
620,120,2024-02-01,26518,1392,27910
621,121,2024-02-01,22227,4892,27119
622,122,2024-02-01,33668,2201,35869
623,123,2024-02-01,41349,2363,43712
624,124,2024-02-01,45789,1897,47686
625,125,2024-02-01,18399,2070,20469
626,126,2024-02-01,18219,4659,22878
627,127,2024-02-01,11216,1490,12706
628,128,2024-02-01,46835,4092,50927
629,129,2024-02-01,16148,250,16398
630,130,2024-02-01,34501,2082,36583
631,131,2024-02-01,44132,1831,45963
632,132,2024-02-01,21298,872,22170
633,133,2024-02-01,33425,804,34229
634,134,2024-02-01,30352,-403,29949
635,135,2024-02-01,48037,3596,51633
636,136,2024-02-01,26251,4337,30588
637,137,2024-02-01,36896,2211,39107
638,138,2024-02-01,39555,260,39815
639,139,2024-02-01,29802,1699,31501
640,140,2024-02-01,14065,4249,18314
641,141,2024-02-01,30209,2228,32437
642,142,2024-02-01,23156,3280,26436
643,143,2024-02-01,18047,3774,21821
644,144,2024-02-01,27433,529,27962
645,145,2024-02-01,49775,4722,54497
646,146,2024-02-01,10963,3004,13967
647,147,2024-02-01,23617,678,24295
648,148,2024-02-01,37419,3772,41191
649,149,2024-02-01,11562,4634,16196
650,150,2024-02-01,21014,2984,23998
651,151,2024-02-01,30520,3010,33530
652,152,2024-02-01,14869,2019,16888
653,153,2024-02-01,18101,1621,19722
654,154,2024-02-01,47466,345,47811
655,155,2024-02-01,41844,985,42829
656,156,2024-02-01,37723,2289,40012
657,157,2024-02-01,18450,2678,21128
658,158,2024-02-01,20252,394,20646
659,159,2024-02-01,49170,3475,52645
660,160,2024-02-01,32406,4326,36732
661,161,2024-02-01,12356,273,12629
662,162,2024-02-01,20597,890,21487
663,163,2024-02-01,11180,4403,15583
664,164,2024-02-01,25934,4719,30653
665,165,2024-02-01,31437,3632,35069
666,166,2024-02-01,37601,2591,40192
667,167,2024-02-01,12117,3141,15258
668,168,2024-02-01,45093,2953,48046
669,169,2024-02-01,15043,2496,17539
670,170,2024-02-01,29564,294,29858
671,171,2024-02-01,35603,2697,38300
672,172,2024-02-01,25581,1386,26967
673,173,2024-02-01,46858,3744,50602
674,174,2024-02-01,46360,4842,51202
675,175,2024-02-01,42394,4507,46901
676,176,2024-02-01,19026,2795,21821
677,177,2024-02-01,35367,2841,38208
678,178,2024-02-01,46827,3968,50795
679,179,2024-02-01,43309,1910,45219
680,180,2024-02-01,0,2873,2873
681,181,2024-02-01,19108,3812,22920
682,182,2024-02-01,20049,482,20531
683,183,2024-02-01,19562,3607,23169
684,184,2024-02-01,26005,770,26775
685,185,2024-02-01,26848,3902,30750
686,186,2024-02-01,30131,1460,31591
687,187,2024-02-01,18997,1473,20470
688,188,2024-02-01,34071,2961,37032
689,189,2024-02-01,17168,2048,19216
690,190,2024-02-01,40378,1633,42011
691,191,2024-02-01,42370,2800,45170
692,192,2024-02-01,23184,2403,25587
693,193,2024-02-01,14176,2850,17026
694,194,2024-02-01,28116,-122,27994
695,195,2024-02-01,34837,2074,36911
696,196,2024-02-01,13999,2948,16947
697,197,2024-02-01,27881,367,28248
698,198,2024-02-01,16781,4357,21138
699,199,2024-02-01,15564,1615,17179
700,200,2024-02-01,20784,3070,23854
701,201,2024-02-01,36421,1824,38245
702,202,2024-02-01,46605,4254,50859
703,203,2024-02-01,18728,2586,21314
704,204,2024-02-01,41573,1554,43127
705,205,2024-02-01,37154,379,37533
706,206,2024-02-01,14100,4425,18525
707,207,2024-02-01,15618,2677,18295
708,208,2024-02-01,16970,2310,19280
709,209,2024-02-01,49263,4939,54202
710,210,2024-02-01,26844,4536,31380
711,211,2024-02-01,26710,1314,28024
712,212,2024-02-01,26721,2275,28996
713,213,2024-02-01,47794,3508,51302
714,214,2024-02-01,49827,2277,52104
715,215,2024-02-01,31989,3298,35287
716,216,2024-02-01,36982,4308,41290
717,217,2024-02-01,13006,1072,14078
718,218,2024-02-01,17421,412,17833
719,219,2024-02-01,41962,4466,46428
720,220,2024-02-01,30816,2961,33777
721,221,2024-02-01,43608,2382,45990
722,222,2024-02-01,41998,1465,43463
723,223,2024-02-01,25152,4705,29857
724,224,2024-02-01,47955,4622,52577
725,225,2024-02-01,47835,3020,50855
726,226,2024-02-01,23917,2843,26760
727,227,2024-02-01,33338,1586,34924
728,228,2024-02-01,26673,2884,29557
729,229,2024-02-01,43348,3735,47083
730,230,2024-02-01,17654,4910,22564
731,231,2024-02-01,17154,4480,21634
732,232,2024-02-01,34800,516,35316
733,233,2024-02-01,13725,2404,16129
734,234,2024-02-01,39309,850,40159
735,235,2024-02-01,16669,345,17014
736,236,2024-02-01,39615,2479,42094
737,237,2024-02-01,26357,4943,31300
738,238,2024-02-01,49228,3536,52764
739,239,2024-02-01,39194,423,39617
740,240,2024-02-01,25587,3255,28842
741,241,2024-02-01,20271,3333,23604
742,242,2024-02-01,39834,2213,42047
743,243,2024-02-01,30074,4966,35040
744,244,2024-02-01,28118,270,28388
745,245,2024-02-01,49518,1831,51349
746,246,2024-02-01,30335,364,30699
747,247,2024-02-01,47250,3461,50711
748,248,2024-02-01,39598,3224,42822
749,249,2024-02-01,27850,1814,29664
750,250,2024-02-01,26704,826,27530
751,251,2024-02-01,16104,1565,17669
752,252,2024-02-01,35904,292,36196
753,253,2024-02-01,31762,3259,35021
754,254,2024-02-01,19567,2563,22130
755,255,2024-02-01,11085,3146,14231
756,256,2024-02-01,24626,2743,27369
757,257,2024-02-01,41089,2776,43865
758,258,2024-02-01,41362,460,41822
759,259,2024-02-01,44349,3396,47745
760,260,2024-02-01,42374,4584,46958
761,261,2024-02-01,41247,3374,44621
762,262,2024-02-01,37839,3161,41000
763,263,2024-02-01,49441,3810,53251
764,264,2024-02-01,22050,439,22489
765,265,2024-02-01,17434,1466,18900
766,266,2024-02-01,36346,46,36392
767,267,2024-02-01,41663,3359,45022
768,268,2024-02-01,33127,3966,37093
769,269,2024-02-01,33166,1045,34211
770,270,2024-02-01,13628,880,14508
771,271,2024-02-01,47001,1379,48380
772,272,2024-02-01,49882,4602,54484
773,273,2024-02-01,14869,3599,18468
774,274,2024-02-01,21655,315,21970
775,275,2024-02-01,29070,43,29113
776,276,2024-02-01,49467,403,49870
777,277,2024-02-01,39218,1423,40641
778,278,2024-02-01,40775,485,41260
779,279,2024-02-01,37610,1243,38853
780,280,2024-02-01,43490,7,43497
781,281,2024-02-01,15345,4018,19363
782,282,2024-02-01,46448,826,47274
783,283,2024-02-01,23015,1410,24425
784,284,2024-02-01,33691,2368,36059
785,285,2024-02-01,18749,3122,21871
786,286,2024-02-01,47097,3679,50776
787,287,2024-02-01,26040,413,26453
788,288,2024-02-01,34289,4773,39062
789,289,2024-02-01,30331,454,30785
790,290,2024-02-01,31677,598,32275
791,291,2024-02-01,27629,1679,29308
792,292,2024-02-01,44683,3861,48544
793,293,2024-02-01,16594,2855,19449
794,294,2024-02-01,23429,1194,24623
795,295,2024-02-01,10373,2900,13273
796,296,2024-02-01,36663,1100,37763
797,297,2024-02-01,45729,2674,48403
798,298,2024-02-01,13395,3415,16810
799,299,2024-02-01,13990,699,14689
800,300,2024-02-01,38042,2694,40736
801,301,2024-02-01,30087,-3119,26968
802,302,2024-02-01,41678,3238,44916
803,303,2024-02-01,22526,4210,26736
804,304,2024-02-01,28971,627,29598
805,305,2024-02-01,37105,563,37668
806,306,2024-02-01,23000,-1121,21879
807,307,2024-02-01,18620,500,19120
808,308,2024-02-01,25942,1694,27636
809,309,2024-02-01,42250,2105,44355
810,310,2024-02-01,0,522,522
811,311,2024-02-01,38410,4741,43151
812,312,2024-02-01,34296,969,35265
813,313,2024-02-01,10077,4492,14569
814,314,2024-02-01,26952,2285,29237
815,315,2024-02-01,19047,796,19843
816,316,2024-02-01,38830,2893,41723
817,317,2024-02-01,42880,4175,47055
818,318,2024-02-01,48359,1523,49882
819,319,2024-02-01,19307,2718,22025
820,320,2024-02-01,38479,556,39035
821,321,2024-02-01,40010,349,40359
822,322,2024-02-01,49026,4469,53495
823,323,2024-02-01,44156,4295,48451
824,324,2024-02-01,31066,2939,34005
825,325,2024-02-01,38952,4811,43763
826,326,2024-02-01,21349,2137,23486
827,327,2024-02-01,47340,-1029,46311
828,328,2024-02-01,48583,4291,52874
829,329,2024-02-01,16498,4465,20963
830,330,2024-02-01,39062,466,39528
831,331,2024-02-01,47438,3742,51180
832,332,2024-02-01,46991,4945,51936
833,333,2024-02-01,38989,3724,42713
834,334,2024-02-01,44845,92,44937
835,335,2024-02-01,45742,948,46690
836,336,2024-02-01,29398,3091,32489
837,337,2024-02-01,28146,4905,33051
838,338,2024-02-01,16937,91,17028
839,339,2024-02-01,44201,3211,47412
840,340,2024-02-01,25442,4481,29923
841,341,2024-02-01,38152,1184,39336
842,342,2024-02-01,15658,4821,20479
843,343,2024-02-01,19457,1935,21392
844,344,2024-02-01,24004,3480,27484
845,345,2024-02-01,29766,511,30277
846,346,2024-02-01,31161,1640,32801
847,347,2024-02-01,30989,2061,33050
848,348,2024-02-01,36957,3825,40782
849,349,2024-02-01,35893,1087,36980
850,350,2024-02-01,13733,2585,16318
851,351,2024-02-01,34910,1473,36383
852,352,2024-02-01,22928,412,23340
853,353,2024-02-01,46702,3119,49821
854,354,2024-02-01,11276,1887,13163
855,355,2024-02-01,21330,1001,22331
856,356,2024-02-01,32114,528,32642
857,357,2024-02-01,36058,309,36367
858,358,2024-02-01,45472,4758,50230
859,359,2024-02-01,42317,4042,46359
860,360,2024-02-01,41804,328,42132
861,361,2024-02-01,17323,2037,19360
862,362,2024-02-01,0,-769,-769
863,363,2024-02-01,24896,2629,27525
864,364,2024-02-01,38505,-1533,36972
865,365,2024-02-01,40431,4634,45065
866,366,2024-02-01,26866,2069,28935
867,367,2024-02-01,0,3517,3517
868,368,2024-02-01,21249,2869,24118
869,369,2024-02-01,31159,686,31845
870,370,2024-02-01,48271,2652,50923
871,371,2024-02-01,29290,3831,33121
872,372,2024-02-01,14522,3520,18042
873,373,2024-02-01,25222,1228,26450
874,374,2024-02-01,39700,3765,43465
875,375,2024-02-01,37997,3453,41450
876,376,2024-02-01,31455,2280,33735
877,377,2024-02-01,10323,3909,14232
878,378,2024-02-01,22042,4600,26642
879,379,2024-02-01,17188,3472,20660
880,380,2024-02-01,28189,2829,31018
881,381,2024-02-01,27094,1743,28837
882,382,2024-02-01,23436,4624,28060
883,383,2024-02-01,31021,4705,35726
884,384,2024-02-01,19888,2764,22652
885,385,2024-02-01,43355,517,43872
886,386,2024-02-01,45830,171,46001
887,387,2024-02-01,41786,4374,46160
888,388,2024-02-01,36134,2757,38891
889,389,2024-02-01,37538,2099,39637
890,390,2024-02-01,32657,11,32668
891,391,2024-02-01,16363,2420,18783
892,392,2024-02-01,39122,1724,40846
893,393,2024-02-01,13400,799,14199
894,394,2024-02-01,35982,3964,39946
895,395,2024-02-01,46600,1660,48260
896,396,2024-02-01,37895,3937,41832
897,397,2024-02-01,46346,2173,48519
898,398,2024-02-01,17890,2906,20796
899,399,2024-02-01,34954,3258,38212
900,400,2024-02-01,24624,1825,26449
901,401,2024-02-01,42326,3515,45841
902,402,2024-02-01,49482,1637,51119
903,403,2024-02-01,32868,747,33615
904,404,2024-02-01,42974,4482,47456
905,405,2024-02-01,17430,401,17831
906,406,2024-02-01,39032,625,39657
907,407,2024-02-01,18549,-368,18181
908,408,2024-02-01,25587,433,26020
909,409,2024-02-01,36426,1374,37800
910,410,2024-02-01,44326,2693,47019
911,411,2024-02-01,44012,1383,45395
912,412,2024-02-01,10451,4265,14716
913,413,2024-02-01,27995,2726,30721
914,414,2024-02-01,26577,4631,31208
915,415,2024-02-01,24519,3486,28005
916,416,2024-02-01,37451,221,37672
917,417,2024-02-01,38921,4224,43145
918,418,2024-02-01,44365,1659,46024
919,419,2024-02-01,41056,-3856,37200
920,420,2024-02-01,23156,4384,27540
921,421,2024-02-01,46865,94,46959
922,422,2024-02-01,40296,2046,42342
923,423,2024-02-01,16557,2178,18735
924,424,2024-02-01,11277,4562,15839
925,425,2024-02-01,19183,2623,21806
926,426,2024-02-01,34748,796,35544
927,427,2024-02-01,24360,2345,26705
928,428,2024-02-01,32405,1494,33899
929,429,2024-02-01,49470,3743,53213
930,430,2024-02-01,49501,2429,51930
931,431,2024-02-01,41469,3253,44722
932,432,2024-02-01,45933,1398,47331
933,433,2024-02-01,12678,2219,14897
934,434,2024-02-01,21312,-3318,17994
935,435,2024-02-01,38042,4612,42654
936,436,2024-02-01,43819,2590,46409
937,437,2024-02-01,46125,2699,48824
938,438,2024-02-01,32104,1048,33152
939,439,2024-02-01,40645,3830,44475
940,440,2024-02-01,26476,629,27105
941,441,2024-02-01,35186,661,35847
942,442,2024-02-01,14915,1945,16860
943,443,2024-02-01,18206,539,18745
944,444,2024-02-01,20830,3668,24498
945,445,2024-02-01,10294,2198,12492
946,446,2024-02-01,17768,1256,19024
947,447,2024-02-01,45386,4982,50368
948,448,2024-02-01,49527,4585,54112
949,449,2024-02-01,28990,1619,30609
950,450,2024-02-01,19479,3543,23022
951,451,2024-02-01,30167,2456,32623
952,452,2024-02-01,35103,2268,37371
953,453,2024-02-01,22008,2938,24946
954,454,2024-02-01,44498,4224,48722
955,455,2024-02-01,24955,1275,26230
956,456,2024-02-01,29468,2125,31593
957,457,2024-02-01,37576,2974,40550
958,458,2024-02-01,39690,4272,43962
959,459,2024-02-01,21625,-3333,18292
960,460,2024-02-01,15972,3821,19793
961,461,2024-02-01,48994,2998,51992
962,462,2024-02-01,38093,1819,39912
963,463,2024-02-01,24460,342,24802
964,464,2024-02-01,20358,4542,24900
965,465,2024-02-01,35600,951,36551
966,466,2024-02-01,20826,189,21015
967,467,2024-02-01,30887,2246,33133
968,468,2024-02-01,14753,3009,17762
969,469,2024-02-01,35987,4443,40430
970,470,2024-02-01,27562,2490,30052
971,471,2024-02-01,32583,4422,37005
972,472,2024-02-01,34049,4266,38315
973,473,2024-02-01,0,-4519,-4519
974,474,2024-02-01,30332,3613,33945
975,475,2024-02-01,39371,2312,41683
976,476,2024-02-01,0,4029,4029
977,477,2024-02-01,38204,1854,40058
978,478,2024-02-01,24122,3542,27664
979,479,2024-02-01,24484,3544,28028
980,480,2024-02-01,17019,4279,21298
981,481,2024-02-01,24360,1471,25831
982,482,2024-02-01,40553,3979,44532
983,483,2024-02-01,30372,2312,32684
984,484,2024-02-01,20935,2867,23802
985,485,2024-02-01,30991,4880,35871
986,486,2024-02-01,30585,4737,35322
987,487,2024-02-01,30107,1139,31246
988,488,2024-02-01,24928,3096,28024
989,489,2024-02-01,40902,1559,42461
990,490,2024-02-01,38565,1521,40086
991,491,2024-02-01,46733,4262,50995
992,492,2024-02-01,44228,1477,45705
993,493,2024-02-01,21200,2620,23820
994,494,2024-02-01,14468,3728,18196
995,495,2024-02-01,29500,4980,34480
996,496,2024-02-01,23710,2390,26100
997,497,2024-02-01,43093,3245,46338
998,498,2024-02-01,26093,4525,30618
999,499,2024-02-01,11951,4289,16240
1000,500,2024-02-01,31553,1432,32985
1001,1,2024-03-01,19936,-3177,16759
1002,2,2024-03-01,43105,1105,44210
1003,3,2024-03-01,44592,4205,48797
1004,4,2024-03-01,40989,2307,43296
1005,5,2024-03-01,25017,698,25715
1006,6,2024-03-01,39050,-3926,35124
1007,7,2024-03-01,29485,2127,31612
1008,8,2024-03-01,41784,3436,45220
1009,9,2024-03-01,39560,4783,44343
1010,10,2024-03-01,44128,2500,46628
1011,11,2024-03-01,29910,3223,33133
1012,12,2024-03-01,19700,117,19817
1013,13,2024-03-01,10055,3859,13914
1014,14,2024-03-01,22047,954,23001
1015,15,2024-03-01,29782,925,30707
1016,16,2024-03-01,23163,4761,27924
1017,17,2024-03-01,16496,730,17226
1018,18,2024-03-01,20005,3083,23088
1019,19,2024-03-01,44002,3274,47276
1020,20,2024-03-01,31297,4871,36168
1021,21,2024-03-01,43913,439,44352
1022,22,2024-03-01,16002,1329,17331
1023,23,2024-03-01,35643,2334,37977
1024,24,2024-03-01,24659,418,25077
1025,25,2024-03-01,11459,1412,12871
1026,26,2024-03-01,39917,4513,44430
1027,27,2024-03-01,19187,1282,20469
1028,28,2024-03-01,22341,492,22833
1029,29,2024-03-01,16460,1370,17830
1030,30,2024-03-01,18929,2678,21607
1031,31,2024-03-01,25668,3277,28945
1032,32,2024-03-01,15178,2961,18139
1033,33,2024-03-01,24036,1865,25901
1034,34,2024-03-01,21054,941,21995
1035,35,2024-03-01,47636,1081,48717
1036,36,2024-03-01,46895,4765,51660
1037,37,2024-03-01,34614,4998,39612
1038,38,2024-03-01,39494,2597,42091
1039,39,2024-03-01,26891,4040,30931
1040,40,2024-03-01,42705,3512,46217
1041,41,2024-03-01,39526,4675,44201
1042,42,2024-03-01,31391,1282,32673
1043,43,2024-03-01,18533,3903,22436
1044,44,2024-03-01,44796,3488,48284
1045,45,2024-03-01,24985,4983,29968
1046,46,2024-03-01,26151,1702,27853
1047,47,2024-03-01,30888,530,31418
1048,48,2024-03-01,43953,2890,46843
1049,49,2024-03-01,40957,-2279,38678
1050,50,2024-03-01,30079,2854,32933
1051,51,2024-03-01,47534,1361,48895
1052,52,2024-03-01,14961,1909,16870
1053,53,2024-03-01,31207,1709,32916
1054,54,2024-03-01,27481,3803,31284
1055,55,2024-03-01,39112,1804,40916
1056,56,2024-03-01,47083,338,47421
1057,57,2024-03-01,25152,710,25862
1058,58,2024-03-01,20730,-2670,18060
1059,59,2024-03-01,18302,1347,19649
1060,60,2024-03-01,34755,2198,36953
1061,61,2024-03-01,25031,541,25572
1062,62,2024-03-01,35874,2731,38605
1063,63,2024-03-01,26180,4261,30441
1064,64,2024-03-01,23901,1831,25732
1065,65,2024-03-01,41088,1630,42718
1066,66,2024-03-01,17689,1366,19055
1067,67,2024-03-01,31282,4446,35728
1068,68,2024-03-01,15403,4789,20192
1069,69,2024-03-01,25341,-4928,20413
1070,70,2024-03-01,27655,1419,29074
1071,71,2024-03-01,33297,1476,34773
1072,72,2024-03-01,29078,4161,33239
1073,73,2024-03-01,40342,1997,42339
1074,74,2024-03-01,15191,3504,18695
1075,75,2024-03-01,28734,3025,31759
1076,76,2024-03-01,40712,2799,43511
1077,77,2024-03-01,0,3713,3713
1078,78,2024-03-01,20682,782,21464
1079,79,2024-03-01,37472,1828,39300
1080,80,2024-03-01,33894,4391,38285
1081,81,2024-03-01,39041,2335,41376
1082,82,2024-03-01,45829,3936,49765
1083,83,2024-03-01,37231,3782,41013
1084,84,2024-03-01,14168,2298,16466
1085,85,2024-03-01,37380,1198,38578
1086,86,2024-03-01,12388,1439,13827
1087,87,2024-03-01,34371,2876,37247
1088,88,2024-03-01,47514,2343,49857
1089,89,2024-03-01,29436,1094,30530
1090,90,2024-03-01,37875,1378,39253
1091,91,2024-03-01,42231,1260,43491
1092,92,2024-03-01,34322,3891,38213
1093,93,2024-03-01,45219,1430,46649
1094,94,2024-03-01,47584,2542,50126
1095,95,2024-03-01,12471,3079,15550
1096,96,2024-03-01,37704,4171,41875
1097,97,2024-03-01,24638,546,25184
1098,98,2024-03-01,36233,3413,39646
1099,99,2024-03-01,32378,3134,35512
1100,100,2024-03-01,28469,433,28902
1101,101,2024-03-01,46514,443,46957
1102,102,2024-03-01,33245,929,34174
1103,103,2024-03-01,12672,4957,17629
1104,104,2024-03-01,35915,757,36672
1105,105,2024-03-01,44156,4815,48971
1106,106,2024-03-01,13176,3221,16397
1107,107,2024-03-01,33744,2775,36519
1108,108,2024-03-01,22887,3136,26023
1109,109,2024-03-01,43464,4439,47903
1110,110,2024-03-01,32323,-3241,29082
1111,111,2024-03-01,26226,2377,28603
1112,112,2024-03-01,24271,4871,29142
1113,113,2024-03-01,46927,4286,51213
1114,114,2024-03-01,27331,4945,32276
1115,115,2024-03-01,32955,707,33662
1116,116,2024-03-01,18902,3550,22452
1117,117,2024-03-01,21684,3663,25347
1118,118,2024-03-01,38881,1424,40305
1119,119,2024-03-01,29528,4083,33611
1120,120,2024-03-01,12881,641,13522
1121,121,2024-03-01,25209,2676,27885
1122,122,2024-03-01,14778,1783,16561
1123,123,2024-03-01,31991,2718,34709
1124,124,2024-03-01,34163,96,34259
1125,125,2024-03-01,16675,2383,19058
1126,126,2024-03-01,14099,3050,17149
1127,127,2024-03-01,12769,1032,13801
1128,128,2024-03-01,27168,4344,31512
1129,129,2024-03-01,17265,1319,18584
1130,130,2024-03-01,47388,2323,49711
1131,131,2024-03-01,14973,4832,19805
1132,132,2024-03-01,16945,2419,19364
1133,133,2024-03-01,36960,1492,38452
1134,134,2024-03-01,27316,4327,31643
1135,135,2024-03-01,10987,3106,14093
1136,136,2024-03-01,26392,2159,28551
1137,137,2024-03-01,34963,4668,39631
1138,138,2024-03-01,10210,1422,11632
1139,139,2024-03-01,0,978,978
1140,140,2024-03-01,23201,1276,24477
1141,141,2024-03-01,30267,3690,33957
1142,142,2024-03-01,21868,1949,23817
1143,143,2024-03-01,16339,321,16660
1144,144,2024-03-01,24918,4262,29180
1145,145,2024-03-01,17350,857,18207
1146,146,2024-03-01,31147,2323,33470
1147,147,2024-03-01,25548,2394,27942
1148,148,2024-03-01,0,3129,3129
1149,149,2024-03-01,32558,3815,36373
1150,150,2024-03-01,47663,599,48262
1151,151,2024-03-01,29424,2311,31735
1152,152,2024-03-01,44164,3514,47678
1153,153,2024-03-01,34777,1776,36553
1154,154,2024-03-01,15986,507,16493
1155,155,2024-03-01,25968,4293,30261
1156,156,2024-03-01,40514,1087,41601
1157,157,2024-03-01,17567,2649,20216
1158,158,2024-03-01,21788,4088,25876
1159,159,2024-03-01,25288,2801,28089
1160,160,2024-03-01,19147,1504,20651
1161,161,2024-03-01,24521,124,24645
1162,162,2024-03-01,49556,2376,51932
1163,163,2024-03-01,10624,242,10866
1164,164,2024-03-01,29279,4526,33805
1165,165,2024-03-01,29677,1432,31109
1166,166,2024-03-01,14920,1883,16803
1167,167,2024-03-01,25061,2696,27757
1168,168,2024-03-01,42576,3463,46039
1169,169,2024-03-01,41269,3338,44607
1170,170,2024-03-01,47558,3179,50737
1171,171,2024-03-01,12276,2721,14997
1172,172,2024-03-01,45756,383,46139
1173,173,2024-03-01,49329,2781,52110
1174,174,2024-03-01,12436,2613,15049
1175,175,2024-03-01,11552,1904,13456
1176,176,2024-03-01,43803,4642,48445
1177,177,2024-03-01,41062,1420,42482
1178,178,2024-03-01,24859,4143,29002
1179,179,2024-03-01,0,3202,3202
1180,180,2024-03-01,35109,2157,37266
1181,181,2024-03-01,33089,3080,36169
1182,182,2024-03-01,44435,3127,47562
1183,183,2024-03-01,0,3245,3245
1184,184,2024-03-01,42378,4894,47272
1185,185,2024-03-01,38970,689,39659
1186,186,2024-03-01,36471,3329,39800
1187,187,2024-03-01,29169,3855,33024
1188,188,2024-03-01,10034,-2300,7734
1189,189,2024-03-01,39193,1691,40884
1190,190,2024-03-01,12137,2900,15037
1191,191,2024-03-01,27783,4841,32624
1192,192,2024-03-01,39298,1341,40639
1193,193,2024-03-01,34046,3081,37127
1194,194,2024-03-01,37277,1246,38523
1195,195,2024-03-01,29324,1511,30835
1196,196,2024-03-01,48206,4669,52875
1197,197,2024-03-01,31956,2829,34785
1198,198,2024-03-01,26892,4242,31134
1199,199,2024-03-01,14751,3296,18047
1200,200,2024-03-01,35797,1696,37493
1201,201,2024-03-01,20770,2128,22898
1202,202,2024-03-01,29279,4476,33755
1203,203,2024-03-01,25501,3028,28529
1204,204,2024-03-01,39938,1865,41803
1205,205,2024-03-01,32134,1003,33137
1206,206,2024-03-01,28418,3554,31972
1207,207,2024-03-01,43889,248,44137
1208,208,2024-03-01,26567,3025,29592
1209,209,2024-03-01,42166,662,42828
1210,210,2024-03-01,26423,3487,29910
1211,211,2024-03-01,41205,4239,45444
1212,212,2024-03-01,23377,3252,26629
1213,213,2024-03-01,19855,882,20737
1214,214,2024-03-01,11795,3757,15552
1215,215,2024-03-01,12379,2414,14793
1216,216,2024-03-01,23606,453,24059
1217,217,2024-03-01,29683,1995,31678
1218,218,2024-03-01,44108,2388,46496
1219,219,2024-03-01,28351,2870,31221
1220,220,2024-03-01,34791,1225,36016
1221,221,2024-03-01,20272,1238,21510
1222,222,2024-03-01,20179,4478,24657
1223,223,2024-03-01,18530,1080,19610
1224,224,2024-03-01,41484,4225,45709
1225,225,2024-03-01,40285,3235,43520
1226,226,2024-03-01,15379,148,15527
1227,227,2024-03-01,40256,360,40616
1228,228,2024-03-01,25648,4454,30102
1229,229,2024-03-01,23256,1485,24741
1230,230,2024-03-01,20791,3745,24536
1231,231,2024-03-01,24418,4169,28587
1232,232,2024-03-01,28267,2422,30689
1233,233,2024-03-01,26313,759,27072
1234,234,2024-03-01,37788,1199,38987
1235,235,2024-03-01,25269,2742,28011
1236,236,2024-03-01,16400,1341,17741
1237,237,2024-03-01,49464,1259,50723
1238,238,2024-03-01,26593,2450,29043
1239,239,2024-03-01,27724,212,27936
1240,240,2024-03-01,24227,2558,26785
1241,241,2024-03-01,14930,4601,19531
1242,242,2024-03-01,34121,686,34807
1243,243,2024-03-01,19436,1734,21170
1244,244,2024-03-01,49187,3880,53067
1245,245,2024-03-01,44784,2831,47615
1246,246,2024-03-01,26062,4568,30630
1247,247,2024-03-01,41234,78,41312
1248,248,2024-03-01,16147,509,16656
1249,249,2024-03-01,24478,2536,27014
1250,250,2024-03-01,40750,4671,45421
1251,251,2024-03-01,29573,2125,31698
1252,252,2024-03-01,29297,3372,32669
1253,253,2024-03-01,10982,4527,15509
1254,254,2024-03-01,24671,4116,28787
1255,255,2024-03-01,13154,4949,18103
1256,256,2024-03-01,30719,3071,33790
1257,257,2024-03-01,37062,4532,41594
1258,258,2024-03-01,42636,3883,46519
1259,259,2024-03-01,14692,4072,18764
1260,260,2024-03-01,42261,1726,43987
1261,261,2024-03-01,20766,1642,22408
1262,262,2024-03-01,32618,4222,36840
1263,263,2024-03-01,37282,1657,38939
1264,264,2024-03-01,14888,1947,16835
1265,265,2024-03-01,11151,353,11504
1266,266,2024-03-01,31920,2620,34540
1267,267,2024-03-01,15326,1471,16797
1268,268,2024-03-01,44268,3617,47885
1269,269,2024-03-01,14532,4560,19092
1270,270,2024-03-01,25814,1598,27412
1271,271,2024-03-01,47371,4199,51570
1272,272,2024-03-01,39753,4406,44159
1273,273,2024-03-01,36222,2895,39117
1274,274,2024-03-01,16142,2061,18203
1275,275,2024-03-01,10347,2644,12991
1276,276,2024-03-01,16399,3879,20278
1277,277,2024-03-01,31225,2198,33423
1278,278,2024-03-01,27115,1488,28603
1279,279,2024-03-01,34787,4845,39632
1280,280,2024-03-01,16413,1674,18087
1281,281,2024-03-01,24849,4046,28895
1282,282,2024-03-01,47632,2662,50294
1283,283,2024-03-01,17681,2833,20514
1284,284,2024-03-01,11995,1286,13281
1285,285,2024-03-01,28881,865,29746
1286,286,2024-03-01,27439,4024,31463
1287,287,2024-03-01,19597,2722,22319
1288,288,2024-03-01,31538,2921,34459
1289,289,2024-03-01,23330,1179,24509
1290,290,2024-03-01,38845,2062,40907
1291,291,2024-03-01,19775,3777,23552
1292,292,2024-03-01,25615,-1535,24080
1293,293,2024-03-01,48946,2853,51799
1294,294,2024-03-01,14278,2117,16395
1295,295,2024-03-01,36341,827,37168
1296,296,2024-03-01,45439,3070,48509
1297,297,2024-03-01,39956,677,40633
1298,298,2024-03-01,15047,3569,18616
1299,299,2024-03-01,49294,389,49683
1300,300,2024-03-01,48822,993,49815
1301,301,2024-03-01,46553,2406,48959
1302,302,2024-03-01,13756,1503,15259
1303,303,2024-03-01,46788,-947,45841
1304,304,2024-03-01,28929,4139,33068
1305,305,2024-03-01,35483,1396,36879
1306,306,2024-03-01,20551,4068,24619
1307,307,2024-03-01,22925,2276,25201
1308,308,2024-03-01,38270,2958,41228
1309,309,2024-03-01,15534,3739,19273
1310,310,2024-03-01,12924,-2954,9970
1311,311,2024-03-01,48921,3411,52332
1312,312,2024-03-01,20608,4827,25435
1313,313,2024-03-01,21144,2629,23773
1314,314,2024-03-01,41105,1558,42663
1315,315,2024-03-01,24606,3514,28120
1316,316,2024-03-01,49184,201,49385
1317,317,2024-03-01,18465,3755,22220
1318,318,2024-03-01,12561,1156,13717
1319,319,2024-03-01,48590,4717,53307
1320,320,2024-03-01,49858,2573,52431
1321,321,2024-03-01,29024,3762,32786
1322,322,2024-03-01,17179,3125,20304
1323,323,2024-03-01,35905,544,36449
1324,324,2024-03-01,23729,2310,26039
1325,325,2024-03-01,11194,567,11761
1326,326,2024-03-01,27245,1085,28330
1327,327,2024-03-01,34716,4898,39614
1328,328,2024-03-01,42455,408,42863
1329,329,2024-03-01,45903,3384,49287
1330,330,2024-03-01,30138,3847,33985
1331,331,2024-03-01,26928,1974,28902
1332,332,2024-03-01,37188,3712,40900
1333,333,2024-03-01,24970,3548,28518
1334,334,2024-03-01,10844,2154,12998
1335,335,2024-03-01,49774,270,50044
1336,336,2024-03-01,21463,3,21466
1337,337,2024-03-01,32644,2863,35507
1338,338,2024-03-01,45546,3068,48614
1339,339,2024-03-01,47947,1215,49162
1340,340,2024-03-01,34720,1257,35977
1341,341,2024-03-01,36148,3940,40088
1342,342,2024-03-01,30935,1927,32862
1343,343,2024-03-01,37484,2348,39832
1344,344,2024-03-01,10937,-1095,9842
1345,345,2024-03-01,33619,4873,38492
1346,346,2024-03-01,12275,2340,14615
1347,347,2024-03-01,22980,1514,24494
1348,348,2024-03-01,28244,3764,32008
1349,349,2024-03-01,38038,437,38475
1350,350,2024-03-01,44888,4469,49357
1351,351,2024-03-01,29092,2452,31544
1352,352,2024-03-01,21052,1821,22873
1353,353,2024-03-01,46894,4151,51045
1354,354,2024-03-01,41898,4745,46643
1355,355,2024-03-01,12737,2741,15478
1356,356,2024-03-01,0,3319,3319
1357,357,2024-03-01,37168,4344,41512
1358,358,2024-03-01,12951,2621,15572
1359,359,2024-03-01,10162,2571,12733
1360,360,2024-03-01,33149,3555,36704
1361,361,2024-03-01,16503,3742,20245
1362,362,2024-03-01,48009,4290,52299
1363,363,2024-03-01,36113,1203,37316
1364,364,2024-03-01,39845,3046,42891
1365,365,2024-03-01,46795,2757,49552
1366,366,2024-03-01,49639,3040,52679
1367,367,2024-03-01,26400,1988,28388
1368,368,2024-03-01,24884,2321,27205
1369,369,2024-03-01,23426,4702,28128
1370,370,2024-03-01,21053,3631,24684
1371,371,2024-03-01,41077,4112,45189
1372,372,2024-03-01,38872,2619,41491
1373,373,2024-03-01,28206,3427,31633
1374,374,2024-03-01,28740,4584,33324
1375,375,2024-03-01,17983,1665,19648
1376,376,2024-03-01,31144,3142,34286
1377,377,2024-03-01,36033,4496,40529
1378,378,2024-03-01,22940,-2091,20849
1379,379,2024-03-01,32665,3510,36175
1380,380,2024-03-01,30828,4156,34984
1381,381,2024-03-01,47743,4023,51766
1382,382,2024-03-01,19364,3273,22637
1383,383,2024-03-01,25372,4114,29486
1384,384,2024-03-01,42340,2168,44508
1385,385,2024-03-01,44541,-1215,43326
1386,386,2024-03-01,16118,2865,18983
1387,387,2024-03-01,31512,4108,35620
1388,388,2024-03-01,31284,1597,32881
1389,389,2024-03-01,12956,4145,17101
1390,390,2024-03-01,10325,1196,11521
1391,391,2024-03-01,25975,1476,27451
1392,392,2024-03-01,24094,3729,27823
1393,393,2024-03-01,16805,2895,19700
1394,394,2024-03-01,36254,28,36282
1395,395,2024-03-01,47166,4350,51516
1396,396,2024-03-01,48635,4517,53152
1397,397,2024-03-01,34798,2097,36895
1398,398,2024-03-01,28610,1555,30165
1399,399,2024-03-01,36619,3077,39696
1400,400,2024-03-01,34835,2113,36948
1401,401,2024-03-01,11832,3565,15397
1402,402,2024-03-01,23715,2413,26128
1403,403,2024-03-01,11886,1012,12898
1404,404,2024-03-01,27869,2085,29954
1405,405,2024-03-01,32453,1322,33775
1406,406,2024-03-01,41832,121,41953
1407,407,2024-03-01,19365,4499,23864
1408,408,2024-03-01,15785,4340,20125
1409,409,2024-03-01,33721,3756,37477
1410,410,2024-03-01,48969,875,49844
1411,411,2024-03-01,11205,2117,13322
1412,412,2024-03-01,10668,4115,14783
1413,413,2024-03-01,41173,4012,45185
1414,414,2024-03-01,30586,3832,34418
1415,415,2024-03-01,35648,518,36166
1416,416,2024-03-01,45768,1078,46846
1417,417,2024-03-01,35322,2042,37364
1418,418,2024-03-01,16414,1723,18137
1419,419,2024-03-01,40236,1519,41755
1420,420,2024-03-01,35191,2861,38052
1421,421,2024-03-01,41295,1784,43079
1422,422,2024-03-01,36478,284,36762
1423,423,2024-03-01,12647,247,12894
1424,424,2024-03-01,27323,1970,29293
1425,425,2024-03-01,17564,766,18330
1426,426,2024-03-01,42083,2404,44487
1427,427,2024-03-01,31279,3075,34354
1428,428,2024-03-01,0,2755,2755
1429,429,2024-03-01,38400,561,38961
1430,430,2024-03-01,22905,675,23580
1431,431,2024-03-01,42135,1990,44125
1432,432,2024-03-01,14120,1456,15576
1433,433,2024-03-01,17527,748,18275
1434,434,2024-03-01,45098,3408,48506
1435,435,2024-03-01,26277,2843,29120
1436,436,2024-03-01,32435,3172,35607
1437,437,2024-03-01,27630,2746,30376
1438,438,2024-03-01,49083,1503,50586
1439,439,2024-03-01,48606,4084,52690
1440,440,2024-03-01,30361,2289,32650
1441,441,2024-03-01,42235,3654,45889
1442,442,2024-03-01,25926,4543,30469
1443,443,2024-03-01,36950,3049,39999
1444,444,2024-03-01,43836,4660,48496
1445,445,2024-03-01,40848,4509,45357
1446,446,2024-03-01,46132,908,47040
1447,447,2024-03-01,44427,3582,48009
1448,448,2024-03-01,17782,2586,20368
1449,449,2024-03-01,49500,4631,54131
1450,450,2024-03-01,22609,1139,23748
1451,451,2024-03-01,20318,2006,22324
1452,452,2024-03-01,48742,2087,50829
1453,453,2024-03-01,49822,1774,51596
1454,454,2024-03-01,18880,1488,20368
1455,455,2024-03-01,20430,2861,23291
1456,456,2024-03-01,32619,3483,36102
1457,457,2024-03-01,36398,3483,39881
1458,458,2024-03-01,24744,2354,27098
1459,459,2024-03-01,45325,1265,46590
1460,460,2024-03-01,15751,1417,17168
1461,461,2024-03-01,26168,4046,30214
1462,462,2024-03-01,22580,1767,24347
1463,463,2024-03-01,41196,1882,43078
1464,464,2024-03-01,11693,3949,15642
1465,465,2024-03-01,45891,2970,48861
1466,466,2024-03-01,45966,753,46719
1467,467,2024-03-01,16439,1868,18307
1468,468,2024-03-01,28672,1713,30385
1469,469,2024-03-01,30088,2480,32568
1470,470,2024-03-01,37813,3994,41807
1471,471,2024-03-01,15763,2756,18519
1472,472,2024-03-01,31607,3653,35260
1473,473,2024-03-01,16095,4443,20538
1474,474,2024-03-01,48010,1486,49496
1475,475,2024-03-01,10272,2722,12994
1476,476,2024-03-01,47534,3075,50609
1477,477,2024-03-01,26915,3062,29977
1478,478,2024-03-01,26668,4247,30915
1479,479,2024-03-01,19270,400,19670
1480,480,2024-03-01,21106,1503,22609
1481,481,2024-03-01,13212,1821,15033
1482,482,2024-03-01,21543,3107,24650
1483,483,2024-03-01,20728,1934,22662
1484,484,2024-03-01,13779,257,14036
1485,485,2024-03-01,38074,-1303,36771
1486,486,2024-03-01,39852,2010,41862
1487,487,2024-03-01,34380,2207,36587
1488,488,2024-03-01,40124,751,40875
1489,489,2024-03-01,30824,456,31280
1490,490,2024-03-01,41524,1412,42936
1491,491,2024-03-01,38638,491,39129
1492,492,2024-03-01,18664,1033,19697
1493,493,2024-03-01,11564,3034,14598
1494,494,2024-03-01,37714,406,38120
1495,495,2024-03-01,20332,3760,24092
1496,496,2024-03-01,34391,3254,37645
1497,497,2024-03-01,31663,2216,33879
1498,498,2024-03-01,26555,2337,28892
1499,499,2024-03-01,20110,4530,24640
1500,500,2024-03-01,12440,4911,17351
1501,1,2024-04-01,34586,1030,35616
1502,2,2024-04-01,29745,1944,31689
1503,3,2024-04-01,33059,4447,37506
1504,4,2024-04-01,12092,4640,16732
1505,5,2024-04-01,18831,932,19763
1506,6,2024-04-01,23314,2667,25981
1507,7,2024-04-01,31632,2295,33927
1508,8,2024-04-01,22028,3962,25990
1509,9,2024-04-01,10012,352,10364
1510,10,2024-04-01,10484,4083,14567
1511,11,2024-04-01,35078,849,35927
1512,12,2024-04-01,22340,4977,27317
1513,13,2024-04-01,36750,3645,40395
1514,14,2024-04-01,13952,4225,18177
1515,15,2024-04-01,27095,649,27744
1516,16,2024-04-01,24267,2421,26688
1517,17,2024-04-01,29814,280,30094
1518,18,2024-04-01,32741,3484,36225
1519,19,2024-04-01,15664,314,15978
1520,20,2024-04-01,15204,1132,16336
1521,21,2024-04-01,42384,2515,44899
1522,22,2024-04-01,18170,209,18379
1523,23,2024-04-01,43189,2311,45500
1524,24,2024-04-01,39682,3326,43008
1525,25,2024-04-01,21120,1752,22872
1526,26,2024-04-01,0,2669,2669
1527,27,2024-04-01,15893,3878,19771
1528,28,2024-04-01,12220,4473,16693
1529,29,2024-04-01,25059,1598,26657
1530,30,2024-04-01,16126,1288,17414
1531,31,2024-04-01,17657,4852,22509
1532,32,2024-04-01,0,404,404
1533,33,2024-04-01,0,358,358
1534,34,2024-04-01,29724,-3848,25876
1535,35,2024-04-01,13119,4394,17513
1536,36,2024-04-01,28203,3343,31546
1537,37,2024-04-01,46313,4754,51067
1538,38,2024-04-01,22675,4334,27009
1539,39,2024-04-01,34370,360,34730
1540,40,2024-04-01,38987,1542,40529
1541,41,2024-04-01,17833,2183,20016
1542,42,2024-04-01,10774,1987,12761
1543,43,2024-04-01,15954,440,16394
1544,44,2024-04-01,22600,1190,23790
1545,45,2024-04-01,47772,4645,52417
1546,46,2024-04-01,34997,1858,36855
1547,47,2024-04-01,36602,258,36860
1548,48,2024-04-01,45756,1545,47301
1549,49,2024-04-01,40637,1718,42355
1550,50,2024-04-01,10156,294,10450
1551,51,2024-04-01,35856,4673,40529
1552,52,2024-04-01,15802,4769,20571
1553,53,2024-04-01,19113,3192,22305
1554,54,2024-04-01,34194,2164,36358
1555,55,2024-04-01,43039,2681,45720
1556,56,2024-04-01,27679,3336,31015
1557,57,2024-04-01,32358,1654,34012
1558,58,2024-04-01,46515,2799,49314
1559,59,2024-04-01,45867,2567,48434
1560,60,2024-04-01,24842,2693,27535
1561,61,2024-04-01,48410,2543,50953
1562,62,2024-04-01,39462,4613,44075
1563,63,2024-04-01,14564,1478,16042
1564,64,2024-04-01,35917,402,36319
1565,65,2024-04-01,36353,3671,40024
1566,66,2024-04-01,31886,711,32597
1567,67,2024-04-01,29926,2934,32860
1568,68,2024-04-01,34021,3882,37903
1569,69,2024-04-01,11545,4660,16205
1570,70,2024-04-01,46802,2679,49481
1571,71,2024-04-01,12379,4878,17257
1572,72,2024-04-01,24238,4286,28524
1573,73,2024-04-01,49086,3557,52643
1574,74,2024-04-01,30919,1385,32304
1575,75,2024-04-01,47286,942,48228
1576,76,2024-04-01,17801,1748,19549
1577,77,2024-04-01,21579,3680,25259
1578,78,2024-04-01,34827,1465,36292
1579,79,2024-04-01,41498,3231,44729
1580,80,2024-04-01,34156,1858,36014
1581,81,2024-04-01,33715,78,33793
1582,82,2024-04-01,23654,413,24067
1583,83,2024-04-01,47025,2696,49721
1584,84,2024-04-01,42565,2220,44785
1585,85,2024-04-01,13665,4177,17842
1586,86,2024-04-01,30385,195,30580
1587,87,2024-04-01,25304,1595,26899
1588,88,2024-04-01,33456,4175,37631
1589,89,2024-04-01,23537,4418,27955
1590,90,2024-04-01,25048,2977,28025
1591,91,2024-04-01,20125,4413,24538
1592,92,2024-04-01,0,222,222
1593,93,2024-04-01,47954,2226,50180
1594,94,2024-04-01,23129,127,23256
1595,95,2024-04-01,47533,2758,50291
1596,96,2024-04-01,12257,4637,16894
1597,97,2024-04-01,34477,1806,36283
1598,98,2024-04-01,10766,1518,12284
1599,99,2024-04-01,25116,1665,26781
1600,100,2024-04-01,41791,644,42435
1601,101,2024-04-01,25159,3188,28347
1602,102,2024-04-01,41652,3074,44726
1603,103,2024-04-01,12979,2580,15559
1604,104,2024-04-01,0,3715,3715
1605,105,2024-04-01,44832,4558,49390
1606,106,2024-04-01,38820,3103,41923
1607,107,2024-04-01,44046,1161,45207
1608,108,2024-04-01,31578,2434,34012
1609,109,2024-04-01,41059,3934,44993
1610,110,2024-04-01,43134,90,43224
1611,111,2024-04-01,42714,4522,47236
1612,112,2024-04-01,17214,3873,21087
1613,113,2024-04-01,49059,3132,52191
1614,114,2024-04-01,29535,804,30339
1615,115,2024-04-01,33719,1089,34808
1616,116,2024-04-01,18076,2526,20602
1617,117,2024-04-01,45123,1757,46880
1618,118,2024-04-01,37779,198,37977
1619,119,2024-04-01,0,1883,1883
1620,120,2024-04-01,41557,2194,43751
1621,121,2024-04-01,21861,1454,23315
1622,122,2024-04-01,30725,1280,32005
1623,123,2024-04-01,25409,4407,29816
1624,124,2024-04-01,32783,844,33627
1625,125,2024-04-01,16344,4635,20979
1626,126,2024-04-01,38793,981,39774
1627,127,2024-04-01,47667,3610,51277
1628,128,2024-04-01,27431,4417,31848
1629,129,2024-04-01,29150,3395,32545
1630,130,2024-04-01,40817,1662,42479
1631,131,2024-04-01,13322,983,14305
1632,132,2024-04-01,36244,4248,40492
1633,133,2024-04-01,46675,4038,50713
1634,134,2024-04-01,14398,4021,18419
1635,135,2024-04-01,14784,1322,16106
1636,136,2024-04-01,38458,2896,41354
1637,137,2024-04-01,26995,219,27214
1638,138,2024-04-01,40209,3521,43730
1639,139,2024-04-01,49871,789,50660
1640,140,2024-04-01,25097,4690,29787
1641,141,2024-04-01,34629,4422,39051
1642,142,2024-04-01,0,3126,3126
1643,143,2024-04-01,18465,4577,23042
1644,144,2024-04-01,23097,3267,26364
1645,145,2024-04-01,35142,1925,37067
1646,146,2024-04-01,42246,3287,45533
1647,147,2024-04-01,13247,1274,14521
1648,148,2024-04-01,12754,2500,15254
1649,149,2024-04-01,24467,1398,25865
1650,150,2024-04-01,29633,530,30163
1651,151,2024-04-01,30294,1631,31925
1652,152,2024-04-01,10867,816,11683
1653,153,2024-04-01,10470,2485,12955
1654,154,2024-04-01,30056,81,30137
1655,155,2024-04-01,27463,846,28309
1656,156,2024-04-01,43737,745,44482
1657,157,2024-04-01,18639,3296,21935
1658,158,2024-04-01,36788,998,37786
1659,159,2024-04-01,41326,2992,44318
1660,160,2024-04-01,25799,3755,29554
1661,161,2024-04-01,36005,1460,37465
1662,162,2024-04-01,23295,4128,27423
1663,163,2024-04-01,21640,391,22031
1664,164,2024-04-01,15127,684,15811
1665,165,2024-04-01,23504,2944,26448
1666,166,2024-04-01,26689,612,27301
1667,167,2024-04-01,42464,2597,45061
1668,168,2024-04-01,40176,1769,41945
1669,169,2024-04-01,21370,2300,23670
1670,170,2024-04-01,43946,3491,47437
1671,171,2024-04-01,29077,609,29686
1672,172,2024-04-01,46917,3686,50603
1673,173,2024-04-01,14273,4942,19215
1674,174,2024-04-01,17296,2745,20041
1675,175,2024-04-01,24256,4528,28784
1676,176,2024-04-01,30043,2830,32873
1677,177,2024-04-01,34406,2649,37055
1678,178,2024-04-01,20992,3263,24255
1679,179,2024-04-01,26330,4453,30783
1680,180,2024-04-01,14574,629,15203
1681,181,2024-04-01,29378,3913,33291
1682,182,2024-04-01,20261,1214,21475
1683,183,2024-04-01,43770,2984,46754
1684,184,2024-04-01,0,827,827
1685,185,2024-04-01,24417,1904,26321
1686,186,2024-04-01,11371,713,12084
1687,187,2024-04-01,10175,4868,15043
1688,188,2024-04-01,38524,4301,42825
1689,189,2024-04-01,35437,1813,37250
1690,190,2024-04-01,16684,802,17486
1691,191,2024-04-01,41382,3982,45364
1692,192,2024-04-01,41541,971,42512
1693,193,2024-04-01,30151,3210,33361
1694,194,2024-04-01,37526,4946,42472
1695,195,2024-04-01,27840,1663,29503
1696,196,2024-04-01,46651,977,47628
1697,197,2024-04-01,26383,4537,30920
1698,198,2024-04-01,40787,3986,44773
1699,199,2024-04-01,13090,1085,14175
1700,200,2024-04-01,31103,2966,34069
1701,201,2024-04-01,11763,849,12612
1702,202,2024-04-01,22512,2984,25496
1703,203,2024-04-01,16150,792,16942
1704,204,2024-04-01,20020,131,20151
1705,205,2024-04-01,17821,1445,19266
1706,206,2024-04-01,30628,1579,32207
1707,207,2024-04-01,34127,16,34143
1708,208,2024-04-01,21475,4189,25664
1709,209,2024-04-01,15558,663,16221
1710,210,2024-04-01,46083,2485,48568
1711,211,2024-04-01,19799,4259,24058
1712,212,2024-04-01,21111,1942,23053
1713,213,2024-04-01,41315,913,42228
1714,214,2024-04-01,18435,1292,19727
1715,215,2024-04-01,39912,1941,41853
1716,216,2024-04-01,35686,3579,39265
1717,217,2024-04-01,45390,2508,47898
1718,218,2024-04-01,46253,1821,48074
1719,219,2024-04-01,11907,325,12232
1720,220,2024-04-01,15616,3023,18639
1721,221,2024-04-01,37448,3000,40448
1722,222,2024-04-01,26854,4385,31239
1723,223,2024-04-01,25349,4765,30114
1724,224,2024-04-01,44535,3084,47619
1725,225,2024-04-01,19878,3669,23547
1726,226,2024-04-01,44762,526,45288
1727,227,2024-04-01,40016,2733,42749
1728,228,2024-04-01,17957,335,18292
1729,229,2024-04-01,28653,2242,30895
1730,230,2024-04-01,42794,1943,44737
1731,231,2024-04-01,31163,2599,33762
1732,232,2024-04-01,32862,2386,35248
1733,233,2024-04-01,12632,1623,14255
1734,234,2024-04-01,47313,919,48232
1735,235,2024-04-01,33512,4716,38228
1736,236,2024-04-01,23741,3933,27674
1737,237,2024-04-01,13782,13,13795
1738,238,2024-04-01,45230,4038,49268
1739,239,2024-04-01,32954,2310,35264
1740,240,2024-04-01,46738,3668,50406
1741,241,2024-04-01,42005,398,42403
1742,242,2024-04-01,10164,4249,14413
1743,243,2024-04-01,43181,427,43608
1744,244,2024-04-01,33622,2369,35991
1745,245,2024-04-01,32035,1301,33336
1746,246,2024-04-01,28441,2787,31228
1747,247,2024-04-01,24889,3092,27981
1748,248,2024-04-01,47847,2659,50506
1749,249,2024-04-01,42073,203,42276
1750,250,2024-04-01,47344,2980,50324
1751,251,2024-04-01,45004,649,45653
1752,252,2024-04-01,16281,3126,19407
1753,253,2024-04-01,19815,850,20665
1754,254,2024-04-01,39566,4821,44387
1755,255,2024-04-01,47281,3056,50337
1756,256,2024-04-01,11271,747,12018
1757,257,2024-04-01,42958,2353,45311
1758,258,2024-04-01,36692,3860,40552
1759,259,2024-04-01,26760,4311,31071
1760,260,2024-04-01,29941,2271,32212
1761,261,2024-04-01,33772,4160,37932
1762,262,2024-04-01,25005,689,25694
1763,263,2024-04-01,49167,2679,51846
1764,264,2024-04-01,48549,3358,51907
1765,265,2024-04-01,48241,2913,51154
1766,266,2024-04-01,28851,2002,30853
1767,267,2024-04-01,37496,1229,38725
1768,268,2024-04-01,42888,3481,46369
1769,269,2024-04-01,31208,1985,33193
1770,270,2024-04-01,46761,2813,49574
1771,271,2024-04-01,20216,3039,23255
1772,272,2024-04-01,24203,-3621,20582
1773,273,2024-04-01,10999,2716,13715
1774,274,2024-04-01,24104,3134,27238
1775,275,2024-04-01,44382,950,45332
1776,276,2024-04-01,0,3418,3418
1777,277,2024-04-01,24076,4948,29024
1778,278,2024-04-01,43367,4894,48261
1779,279,2024-04-01,17921,3035,20956
1780,280,2024-04-01,35353,4055,39408
1781,281,2024-04-01,32224,4947,37171
1782,282,2024-04-01,33153,2007,35160
1783,283,2024-04-01,30432,1428,31860
1784,284,2024-04-01,44446,2566,47012
1785,285,2024-04-01,16060,3381,19441
1786,286,2024-04-01,39976,2844,42820
1787,287,2024-04-01,33594,2341,35935
1788,288,2024-04-01,16312,4688,21000
1789,289,2024-04-01,20692,4643,25335
1790,290,2024-04-01,39349,2926,42275
1791,291,2024-04-01,18239,4999,23238
1792,292,2024-04-01,36218,2609,38827
1793,293,2024-04-01,25782,4709,30491
1794,294,2024-04-01,17327,2993,20320
1795,295,2024-04-01,48204,1979,50183
1796,296,2024-04-01,35096,1727,36823
1797,297,2024-04-01,0,3211,3211
1798,298,2024-04-01,16355,-959,15396
1799,299,2024-04-01,45983,2818,48801
1800,300,2024-04-01,23645,976,24621
1801,301,2024-04-01,21720,1542,23262
1802,302,2024-04-01,14574,3829,18403
1803,303,2024-04-01,15828,507,16335
1804,304,2024-04-01,25647,2870,28517
1805,305,2024-04-01,38434,523,38957
1806,306,2024-04-01,45594,4969,50563
1807,307,2024-04-01,42841,654,43495
1808,308,2024-04-01,20855,2727,23582
1809,309,2024-04-01,42838,3986,46824
1810,310,2024-04-01,35303,1414,36717
1811,311,2024-04-01,12307,2537,14844
1812,312,2024-04-01,48942,4386,53328
1813,313,2024-04-01,25007,984,25991
1814,314,2024-04-01,27786,2179,29965
1815,315,2024-04-01,47087,242,47329
1816,316,2024-04-01,44637,1025,45662
1817,317,2024-04-01,38577,3239,41816
1818,318,2024-04-01,34229,-4819,29410
1819,319,2024-04-01,10569,4115,14684
1820,320,2024-04-01,43462,3635,47097
1821,321,2024-04-01,10977,2400,13377
1822,322,2024-04-01,38969,328,39297
1823,323,2024-04-01,15917,2095,18012
1824,324,2024-04-01,25430,1095,26525
1825,325,2024-04-01,20424,1212,21636
1826,326,2024-04-01,29332,2909,32241
1827,327,2024-04-01,33505,2874,36379
1828,328,2024-04-01,49896,957,50853
1829,329,2024-04-01,11031,864,11895
1830,330,2024-04-01,40968,4020,44988
1831,331,2024-04-01,19744,218,19962
1832,332,2024-04-01,37971,1360,39331
1833,333,2024-04-01,28935,2415,31350
1834,334,2024-04-01,28039,-2579,25460
1835,335,2024-04-01,33989,1018,35007
1836,336,2024-04-01,35892,577,36469
1837,337,2024-04-01,35964,3810,39774
1838,338,2024-04-01,32454,4098,36552
1839,339,2024-04-01,46569,4824,51393
1840,340,2024-04-01,49523,169,49692
1841,341,2024-04-01,16472,4082,20554
1842,342,2024-04-01,28292,4020,32312
1843,343,2024-04-01,14786,3084,17870
1844,344,2024-04-01,20924,3328,24252
1845,345,2024-04-01,42549,2130,44679
1846,346,2024-04-01,26034,3987,30021
1847,347,2024-04-01,40541,874,41415
1848,348,2024-04-01,32981,3035,36016
1849,349,2024-04-01,35739,1538,37277
1850,350,2024-04-01,39245,3111,42356
1851,351,2024-04-01,23714,2344,26058
1852,352,2024-04-01,15459,4734,20193
1853,353,2024-04-01,35971,1117,37088
1854,354,2024-04-01,26426,3715,30141
1855,355,2024-04-01,27450,3941,31391
1856,356,2024-04-01,24316,4789,29105
1857,357,2024-04-01,46024,535,46559
1858,358,2024-04-01,35278,4530,39808
1859,359,2024-04-01,40517,1521,42038
1860,360,2024-04-01,22764,562,23326
1861,361,2024-04-01,27876,3881,31757
1862,362,2024-04-01,38665,853,39518
1863,363,2024-04-01,10259,2848,13107
1864,364,2024-04-01,29005,1888,30893
1865,365,2024-04-01,17938,2066,20004
1866,366,2024-04-01,15087,1580,16667
1867,367,2024-04-01,46580,370,46950
1868,368,2024-04-01,32597,4387,36984
1869,369,2024-04-01,49496,3782,53278
1870,370,2024-04-01,24534,1287,25821
1871,371,2024-04-01,39626,4607,44233
1872,372,2024-04-01,31534,503,32037
1873,373,2024-04-01,45076,3310,48386
1874,374,2024-04-01,36064,3100,39164
1875,375,2024-04-01,23237,3408,26645
1876,376,2024-04-01,14907,1455,16362
1877,377,2024-04-01,42575,1060,43635
1878,378,2024-04-01,29838,3686,33524
1879,379,2024-04-01,49169,453,49622
1880,380,2024-04-01,39968,4817,44785
1881,381,2024-04-01,10551,2617,13168
1882,382,2024-04-01,27712,3506,31218
1883,383,2024-04-01,34777,167,34944
1884,384,2024-04-01,36123,2371,38494
1885,385,2024-04-01,47419,3206,50625
1886,386,2024-04-01,20914,2696,23610
1887,387,2024-04-01,33540,4388,37928
1888,388,2024-04-01,37403,3549,40952
1889,389,2024-04-01,16221,-2289,13932
1890,390,2024-04-01,34367,112,34479
1891,391,2024-04-01,40720,401,41121
1892,392,2024-04-01,12847,401,13248
1893,393,2024-04-01,27337,4376,31713
1894,394,2024-04-01,29296,4705,34001
1895,395,2024-04-01,0,1516,1516
1896,396,2024-04-01,30368,2796,33164
1897,397,2024-04-01,44661,4970,49631
1898,398,2024-04-01,20556,3687,24243
1899,399,2024-04-01,20472,1182,21654
1900,400,2024-04-01,42443,4361,46804
1901,401,2024-04-01,28265,1903,30168
1902,402,2024-04-01,27667,2286,29953
1903,403,2024-04-01,23294,852,24146
1904,404,2024-04-01,36597,297,36894
1905,405,2024-04-01,38003,1019,39022
1906,406,2024-04-01,16873,2592,19465
1907,407,2024-04-01,23372,3690,27062
1908,408,2024-04-01,23554,1912,25466
1909,409,2024-04-01,38728,2669,41397
1910,410,2024-04-01,37935,3297,41232
1911,411,2024-04-01,36828,3736,40564
1912,412,2024-04-01,16363,2099,18462
1913,413,2024-04-01,14388,318,14706
1914,414,2024-04-01,11157,934,12091
1915,415,2024-04-01,11854,4031,15885
1916,416,2024-04-01,18978,1047,20025
1917,417,2024-04-01,14556,4826,19382
1918,418,2024-04-01,14999,349,15348
1919,419,2024-04-01,24184,3927,28111
1920,420,2024-04-01,17387,758,18145
1921,421,2024-04-01,33588,599,34187
1922,422,2024-04-01,27583,2314,29897
1923,423,2024-04-01,28092,-1651,26441
1924,424,2024-04-01,17893,148,18041
1925,425,2024-04-01,16598,2892,19490
1926,426,2024-04-01,18308,3546,21854
1927,427,2024-04-01,38320,1024,39344
1928,428,2024-04-01,40023,460,40483
1929,429,2024-04-01,40617,3604,44221
1930,430,2024-04-01,36181,4566,40747
1931,431,2024-04-01,11647,4426,16073
1932,432,2024-04-01,12728,3338,16066
1933,433,2024-04-01,35329,2132,37461
1934,434,2024-04-01,37185,4652,41837
1935,435,2024-04-01,22116,3991,26107
1936,436,2024-04-01,27624,3432,31056
1937,437,2024-04-01,44396,4152,48548
1938,438,2024-04-01,46917,4889,51806
1939,439,2024-04-01,41400,372,41772
1940,440,2024-04-01,34547,2440,36987
1941,441,2024-04-01,46137,2131,48268
1942,442,2024-04-01,21103,3165,24268
1943,443,2024-04-01,23559,1011,24570
1944,444,2024-04-01,29002,306,29308
1945,445,2024-04-01,40443,2829,43272
1946,446,2024-04-01,30695,4837,35532
1947,447,2024-04-01,26648,3366,30014
1948,448,2024-04-01,31859,3746,35605
1949,449,2024-04-01,39368,3738,43106
1950,450,2024-04-01,48099,2090,50189
1951,451,2024-04-01,24128,4797,28925
1952,452,2024-04-01,17739,4055,21794
1953,453,2024-04-01,32744,1887,34631
1954,454,2024-04-01,31358,4440,35798
1955,455,2024-04-01,47148,1411,48559
1956,456,2024-04-01,44158,172,44330
1957,457,2024-04-01,38199,1749,39948
1958,458,2024-04-01,11461,2490,13951
1959,459,2024-04-01,19747,4042,23789
1960,460,2024-04-01,14994,206,15200
1961,461,2024-04-01,30095,3453,33548
1962,462,2024-04-01,48654,2166,50820
1963,463,2024-04-01,22884,1893,24777
1964,464,2024-04-01,37810,3740,41550
1965,465,2024-04-01,33596,1156,34752
1966,466,2024-04-01,31392,90,31482
1967,467,2024-04-01,24194,415,24609
1968,468,2024-04-01,37769,3560,41329
1969,469,2024-04-01,43212,4679,47891
1970,470,2024-04-01,14470,1825,16295
1971,471,2024-04-01,0,4521,4521
1972,472,2024-04-01,45173,2535,47708
1973,473,2024-04-01,40757,1005,41762
1974,474,2024-04-01,35340,4076,39416
1975,475,2024-04-01,19091,498,19589
1976,476,2024-04-01,27726,287,28013
1977,477,2024-04-01,43324,4940,48264
1978,478,2024-04-01,44606,4927,49533
1979,479,2024-04-01,33916,3651,37567
1980,480,2024-04-01,31261,1755,33016
1981,481,2024-04-01,21742,187,21929
1982,482,2024-04-01,40369,1294,41663
1983,483,2024-04-01,45482,2770,48252
1984,484,2024-04-01,33544,485,34029
1985,485,2024-04-01,28117,2520,30637
1986,486,2024-04-01,27179,942,28121
1987,487,2024-04-01,39864,36,39900
1988,488,2024-04-01,48602,3848,52450
1989,489,2024-04-01,25007,738,25745
1990,490,2024-04-01,25469,1792,27261
1991,491,2024-04-01,14096,0,14096
1992,492,2024-04-01,46400,4504,50904
1993,493,2024-04-01,48855,3240,52095
1994,494,2024-04-01,33366,1780,35146
1995,495,2024-04-01,32762,850,33612
1996,496,2024-04-01,24040,1393,25433
1997,497,2024-04-01,12515,3017,15532
1998,498,2024-04-01,38319,536,38855
1999,499,2024-04-01,0,2829,2829
2000,500,2024-04-01,13132,932,14064
2001,1,2024-05-01,32522,3289,35811
2002,2,2024-05-01,13969,4360,18329
2003,3,2024-05-01,16745,4863,21608
2004,4,2024-05-01,21197,491,21688
2005,5,2024-05-01,47603,1767,49370
2006,6,2024-05-01,25484,68,25552
2007,7,2024-05-01,12750,4100,16850
2008,8,2024-05-01,33923,1307,35230
2009,9,2024-05-01,45221,4103,49324
2010,10,2024-05-01,44720,3954,48674
2011,11,2024-05-01,24546,3936,28482
2012,12,2024-05-01,33349,2947,36296
2013,13,2024-05-01,0,830,830
2014,14,2024-05-01,19885,-4548,15337
2015,15,2024-05-01,15140,2514,17654
2016,16,2024-05-01,24143,114,24257
2017,17,2024-05-01,23003,4673,27676
2018,18,2024-05-01,29639,3320,32959
2019,19,2024-05-01,18058,4397,22455
2020,20,2024-05-01,40226,2187,42413
2021,21,2024-05-01,12818,1724,14542
2022,22,2024-05-01,38345,260,38605
2023,23,2024-05-01,10572,3552,14124
2024,24,2024-05-01,23946,691,24637
2025,25,2024-05-01,16907,4995,21902
2026,26,2024-05-01,20681,301,20982
2027,27,2024-05-01,45148,3668,48816
2028,28,2024-05-01,32136,3702,35838
2029,29,2024-05-01,41883,2506,44389
2030,30,2024-05-01,21575,663,22238
2031,31,2024-05-01,40133,4986,45119
2032,32,2024-05-01,25911,4832,30743
2033,33,2024-05-01,18203,4761,22964
2034,34,2024-05-01,18680,882,19562
2035,35,2024-05-01,45791,599,46390
2036,36,2024-05-01,28227,1083,29310
2037,37,2024-05-01,32052,4446,36498
2038,38,2024-05-01,39278,4935,44213
2039,39,2024-05-01,37916,4124,42040
2040,40,2024-05-01,17021,543,17564
2041,41,2024-05-01,27378,4033,31411
2042,42,2024-05-01,34386,2842,37228
2043,43,2024-05-01,19809,3989,23798
2044,44,2024-05-01,48558,2356,50914
2045,45,2024-05-01,30427,4526,34953
2046,46,2024-05-01,23139,2647,25786
2047,47,2024-05-01,28434,4971,33405
2048,48,2024-05-01,27661,3355,31016
2049,49,2024-05-01,12838,3833,16671
2050,50,2024-05-01,19442,193,19635
2051,51,2024-05-01,31350,1070,32420
2052,52,2024-05-01,10883,2824,13707
2053,53,2024-05-01,43353,2626,45979
2054,54,2024-05-01,17123,2176,19299
2055,55,2024-05-01,22745,1093,23838
2056,56,2024-05-01,24637,3655,28292
2057,57,2024-05-01,47549,3724,51273
2058,58,2024-05-01,0,1856,1856
2059,59,2024-05-01,40092,820,40912
2060,60,2024-05-01,28393,1563,29956
2061,61,2024-05-01,38208,3588,41796
2062,62,2024-05-01,0,2828,2828
2063,63,2024-05-01,38709,3341,42050
2064,64,2024-05-01,42799,4209,47008
2065,65,2024-05-01,34296,108,34404
2066,66,2024-05-01,40989,589,41578
2067,67,2024-05-01,0,4471,4471
2068,68,2024-05-01,42670,3536,46206
2069,69,2024-05-01,33920,4977,38897
2070,70,2024-05-01,42180,1192,43372
2071,71,2024-05-01,29209,2046,31255
2072,72,2024-05-01,33744,4233,37977
2073,73,2024-05-01,26128,3789,29917
2074,74,2024-05-01,30075,2162,32237
2075,75,2024-05-01,10739,248,10987
2076,76,2024-05-01,48840,4974,53814
2077,77,2024-05-01,36169,1472,37641
2078,78,2024-05-01,12859,523,13382
2079,79,2024-05-01,37753,82,37835
2080,80,2024-05-01,28239,1949,30188
2081,81,2024-05-01,16837,3560,20397
2082,82,2024-05-01,41824,4976,46800
2083,83,2024-05-01,25212,2824,28036
2084,84,2024-05-01,49345,178,49523
2085,85,2024-05-01,25674,1324,26998
2086,86,2024-05-01,41831,4842,46673
2087,87,2024-05-01,26556,4851,31407
2088,88,2024-05-01,18739,3862,22601
2089,89,2024-05-01,22882,3962,26844
2090,90,2024-05-01,47431,-2105,45326
2091,91,2024-05-01,40281,2348,42629
2092,92,2024-05-01,21488,807,22295
2093,93,2024-05-01,25202,2754,27956
2094,94,2024-05-01,35551,1424,36975
2095,95,2024-05-01,22593,3983,26576
2096,96,2024-05-01,37593,929,38522
2097,97,2024-05-01,27485,2128,29613
2098,98,2024-05-01,27827,1529,29356
2099,99,2024-05-01,15616,1498,17114
2100,100,2024-05-01,44680,159,44839
2101,101,2024-05-01,24515,4695,29210
2102,102,2024-05-01,46914,4458,51372
2103,103,2024-05-01,12191,3337,15528
2104,104,2024-05-01,48660,3253,51913
2105,105,2024-05-01,26878,3990,30868
2106,106,2024-05-01,23865,2492,26357
2107,107,2024-05-01,43400,1528,44928
2108,108,2024-05-01,13646,1774,15420
2109,109,2024-05-01,27547,3882,31429
2110,110,2024-05-01,39577,4686,44263
2111,111,2024-05-01,38217,714,38931
2112,112,2024-05-01,32322,506,32828
2113,113,2024-05-01,11008,1919,12927
2114,114,2024-05-01,13805,1466,15271
2115,115,2024-05-01,34887,3083,37970
2116,116,2024-05-01,49445,4872,54317
2117,117,2024-05-01,39285,4330,43615
2118,118,2024-05-01,49598,60,49658
2119,119,2024-05-01,13105,1928,15033
2120,120,2024-05-01,26059,3531,29590
2121,121,2024-05-01,30133,2689,32822
2122,122,2024-05-01,43517,3591,47108
2123,123,2024-05-01,12624,4662,17286
2124,124,2024-05-01,21156,2779,23935
2125,125,2024-05-01,23733,1959,25692
2126,126,2024-05-01,13842,3792,17634
2127,127,2024-05-01,49908,4657,54565
2128,128,2024-05-01,21791,3971,25762
2129,129,2024-05-01,44589,3695,48284
2130,130,2024-05-01,48672,542,49214
2131,131,2024-05-01,14624,1131,15755
2132,132,2024-05-01,19074,2306,21380
2133,133,2024-05-01,45846,889,46735
2134,134,2024-05-01,27403,3362,30765
2135,135,2024-05-01,0,2002,2002
2136,136,2024-05-01,46601,1559,48160
2137,137,2024-05-01,0,1504,1504
2138,138,2024-05-01,41405,146,41551
2139,139,2024-05-01,26485,1530,28015
2140,140,2024-05-01,12428,2402,14830
2141,141,2024-05-01,40588,4641,45229
2142,142,2024-05-01,31814,3447,35261
2143,143,2024-05-01,37830,-4980,32850
2144,144,2024-05-01,10274,4343,14617
2145,145,2024-05-01,40488,3640,44128
2146,146,2024-05-01,25701,3587,29288
2147,147,2024-05-01,13170,3997,17167
2148,148,2024-05-01,21321,4303,25624
2149,149,2024-05-01,18926,4593,23519
2150,150,2024-05-01,23658,2502,26160
2151,151,2024-05-01,19105,979,20084
2152,152,2024-05-01,46716,4656,51372
2153,153,2024-05-01,34152,3065,37217
2154,154,2024-05-01,29838,4382,34220
2155,155,2024-05-01,11892,760,12652
2156,156,2024-05-01,14217,4029,18246
2157,157,2024-05-01,15332,4456,19788
2158,158,2024-05-01,25340,2324,27664
2159,159,2024-05-01,38732,3031,41763
2160,160,2024-05-01,14279,4049,18328
2161,161,2024-05-01,48161,758,48919
2162,162,2024-05-01,30470,1504,31974
2163,163,2024-05-01,26995,3294,30289
2164,164,2024-05-01,34286,1002,35288
2165,165,2024-05-01,32752,-1405,31347
2166,166,2024-05-01,10908,3365,14273
2167,167,2024-05-01,12045,1504,13549
2168,168,2024-05-01,48319,862,49181
2169,169,2024-05-01,22718,1249,23967
2170,170,2024-05-01,28212,140,28352
2171,171,2024-05-01,15772,3953,19725
2172,172,2024-05-01,45278,4328,49606
2173,173,2024-05-01,42534,3924,46458
2174,174,2024-05-01,35636,3341,38977
2175,175,2024-05-01,23889,532,24421
2176,176,2024-05-01,40277,3715,43992
2177,177,2024-05-01,21708,2378,24086
2178,178,2024-05-01,13100,3774,16874
2179,179,2024-05-01,11369,-4552,6817
2180,180,2024-05-01,42888,4794,47682
2181,181,2024-05-01,18297,3517,21814
2182,182,2024-05-01,27700,4221,31921
2183,183,2024-05-01,14637,3376,18013
2184,184,2024-05-01,26050,628,26678
2185,185,2024-05-01,19428,-666,18762
2186,186,2024-05-01,22616,3914,26530
2187,187,2024-05-01,25560,-314,25246
2188,188,2024-05-01,20473,2869,23342
2189,189,2024-05-01,26072,4565,30637
2190,190,2024-05-01,40727,1535,42262
2191,191,2024-05-01,25611,411,26022
2192,192,2024-05-01,0,2129,2129
2193,193,2024-05-01,0,235,235
2194,194,2024-05-01,40907,1414,42321
2195,195,2024-05-01,20132,1494,21626
2196,196,2024-05-01,45198,1345,46543
2197,197,2024-05-01,45261,-4730,40531
2198,198,2024-05-01,22848,1127,23975
2199,199,2024-05-01,47088,2566,49654
2200,200,2024-05-01,49274,3345,52619
2201,201,2024-05-01,42396,2324,44720
2202,202,2024-05-01,0,887,887
2203,203,2024-05-01,17817,78,17895
2204,204,2024-05-01,33324,4891,38215
2205,205,2024-05-01,39331,363,39694
2206,206,2024-05-01,39512,1023,40535
2207,207,2024-05-01,47710,1427,49137
2208,208,2024-05-01,29617,3255,32872
2209,209,2024-05-01,42539,1633,44172
2210,210,2024-05-01,15901,3795,19696
2211,211,2024-05-01,29309,4375,33684
2212,212,2024-05-01,26754,2507,29261
2213,213,2024-05-01,25285,2052,27337
2214,214,2024-05-01,23070,349,23419
2215,215,2024-05-01,37907,2185,40092
2216,216,2024-05-01,11833,1477,13310
2217,217,2024-05-01,44544,4760,49304
2218,218,2024-05-01,20449,4799,25248
2219,219,2024-05-01,43718,1573,45291
2220,220,2024-05-01,10666,-3506,7160
2221,221,2024-05-01,42950,4829,47779
2222,222,2024-05-01,32131,1922,34053
2223,223,2024-05-01,21703,2200,23903
2224,224,2024-05-01,21227,3490,24717
2225,225,2024-05-01,29152,1070,30222
2226,226,2024-05-01,36024,511,36535
2227,227,2024-05-01,28593,4363,32956
2228,228,2024-05-01,19137,2596,21733
2229,229,2024-05-01,12037,2431,14468
2230,230,2024-05-01,17331,1261,18592
2231,231,2024-05-01,32216,4853,37069
2232,232,2024-05-01,41989,2285,44274
2233,233,2024-05-01,17102,1356,18458
2234,234,2024-05-01,23206,1314,24520
2235,235,2024-05-01,44487,2309,46796
2236,236,2024-05-01,35361,1387,36748
2237,237,2024-05-01,45266,1947,47213
2238,238,2024-05-01,43457,146,43603
2239,239,2024-05-01,13149,4628,17777
2240,240,2024-05-01,30177,2968,33145
2241,241,2024-05-01,13944,490,14434
2242,242,2024-05-01,25579,775,26354
2243,243,2024-05-01,36015,845,36860
2244,244,2024-05-01,13196,3950,17146
2245,245,2024-05-01,32093,-1505,30588
2246,246,2024-05-01,11198,4682,15880
2247,247,2024-05-01,21600,3964,25564
2248,248,2024-05-01,19028,2808,21836
2249,249,2024-05-01,16924,793,17717
2250,250,2024-05-01,45528,890,46418
2251,251,2024-05-01,42803,2304,45107
2252,252,2024-05-01,35761,2096,37857
2253,253,2024-05-01,20021,4718,24739
2254,254,2024-05-01,39484,4453,43937
2255,255,2024-05-01,31354,1111,32465
2256,256,2024-05-01,15746,4035,19781
2257,257,2024-05-01,31665,413,32078
2258,258,2024-05-01,32452,660,33112
2259,259,2024-05-01,25203,350,25553
2260,260,2024-05-01,45877,4460,50337
2261,261,2024-05-01,36573,3300,39873
2262,262,2024-05-01,29825,801,30626
2263,263,2024-05-01,10948,4289,15237
2264,264,2024-05-01,15848,4603,20451
2265,265,2024-05-01,38007,602,38609
2266,266,2024-05-01,14111,1093,15204
2267,267,2024-05-01,35617,-200,35417
2268,268,2024-05-01,11896,207,12103
2269,269,2024-05-01,18707,178,18885
2270,270,2024-05-01,17078,4693,21771
2271,271,2024-05-01,29043,665,29708
2272,272,2024-05-01,14548,3380,17928
2273,273,2024-05-01,39567,230,39797
2274,274,2024-05-01,17824,1970,19794
2275,275,2024-05-01,25073,442,25515
2276,276,2024-05-01,32410,4546,36956
2277,277,2024-05-01,49078,4919,53997
2278,278,2024-05-01,40140,3614,43754
2279,279,2024-05-01,38232,-1905,36327
2280,280,2024-05-01,16540,2296,18836
2281,281,2024-05-01,18719,801,19520
2282,282,2024-05-01,38354,1396,39750
2283,283,2024-05-01,19621,4202,23823
2284,284,2024-05-01,49810,1744,51554
2285,285,2024-05-01,35427,3564,38991
2286,286,2024-05-01,19118,1287,20405
2287,287,2024-05-01,41904,3512,45416
2288,288,2024-05-01,44856,2390,47246
2289,289,2024-05-01,35023,1961,36984
2290,290,2024-05-01,22808,4109,26917
2291,291,2024-05-01,19494,1,19495
2292,292,2024-05-01,17470,4106,21576
2293,293,2024-05-01,33415,4711,38126
2294,294,2024-05-01,21444,1304,22748
2295,295,2024-05-01,49103,4644,53747
2296,296,2024-05-01,36691,962,37653
2297,297,2024-05-01,33420,447,33867
2298,298,2024-05-01,11347,4652,15999
2299,299,2024-05-01,16054,2199,18253
2300,300,2024-05-01,10828,1212,12040
2301,301,2024-05-01,49539,4088,53627
2302,302,2024-05-01,32922,360,33282
2303,303,2024-05-01,23526,4101,27627
2304,304,2024-05-01,16616,-1076,15540
2305,305,2024-05-01,22542,100,22642
2306,306,2024-05-01,19346,4702,24048
2307,307,2024-05-01,17710,3604,21314
2308,308,2024-05-01,46854,527,47381
2309,309,2024-05-01,34876,4868,39744
2310,310,2024-05-01,10971,1653,12624
2311,311,2024-05-01,12793,4311,17104
2312,312,2024-05-01,26631,157,26788
2313,313,2024-05-01,22679,3070,25749
2314,314,2024-05-01,39491,4185,43676
2315,315,2024-05-01,29992,2373,32365
2316,316,2024-05-01,37328,4716,42044
2317,317,2024-05-01,20647,3058,23705
2318,318,2024-05-01,10071,2729,12800
2319,319,2024-05-01,12931,-746,12185
2320,320,2024-05-01,11386,538,11924
2321,321,2024-05-01,40921,1460,42381
2322,322,2024-05-01,38243,4551,42794
2323,323,2024-05-01,35408,4419,39827
2324,324,2024-05-01,15267,1529,16796
2325,325,2024-05-01,42303,423,42726
2326,326,2024-05-01,41467,738,42205
2327,327,2024-05-01,45601,1495,47096
2328,328,2024-05-01,44397,1037,45434
2329,329,2024-05-01,16204,2969,19173
2330,330,2024-05-01,12969,1616,14585
2331,331,2024-05-01,34170,277,34447
2332,332,2024-05-01,10166,1279,11445
2333,333,2024-05-01,30673,2412,33085
2334,334,2024-05-01,11653,916,12569
2335,335,2024-05-01,29675,4552,34227
2336,336,2024-05-01,41039,1680,42719
2337,337,2024-05-01,17286,4753,22039
2338,338,2024-05-01,27918,231,28149
2339,339,2024-05-01,16735,4171,20906
2340,340,2024-05-01,10496,2663,13159
2341,341,2024-05-01,36029,1327,37356
2342,342,2024-05-01,27343,4381,31724
2343,343,2024-05-01,49437,1868,51305
2344,344,2024-05-01,14777,4971,19748
2345,345,2024-05-01,13895,850,14745
2346,346,2024-05-01,33399,4955,38354
2347,347,2024-05-01,32297,3133,35430
2348,348,2024-05-01,38943,1253,40196
2349,349,2024-05-01,14733,1608,16341
2350,350,2024-05-01,16506,2024,18530
2351,351,2024-05-01,31756,3428,35184
2352,352,2024-05-01,49782,2756,52538
2353,353,2024-05-01,16787,969,17756
2354,354,2024-05-01,13021,1854,14875
2355,355,2024-05-01,24410,2675,27085
2356,356,2024-05-01,15165,853,16018
2357,357,2024-05-01,28338,830,29168
2358,358,2024-05-01,49334,2461,51795
2359,359,2024-05-01,41324,1968,43292
2360,360,2024-05-01,0,4017,4017
2361,361,2024-05-01,39015,890,39905
2362,362,2024-05-01,45932,277,46209
2363,363,2024-05-01,16643,3873,20516
2364,364,2024-05-01,13659,79,13738
2365,365,2024-05-01,37032,3883,40915
2366,366,2024-05-01,0,-1415,-1415
2367,367,2024-05-01,29621,4675,34296
2368,368,2024-05-01,35170,1607,36777
2369,369,2024-05-01,49161,3296,52457
2370,370,2024-05-01,24339,1473,25812
2371,371,2024-05-01,23121,2736,25857
2372,372,2024-05-01,34892,343,35235
2373,373,2024-05-01,22242,1822,24064
2374,374,2024-05-01,39664,4352,44016
2375,375,2024-05-01,12346,3881,16227
2376,376,2024-05-01,31270,3331,34601
2377,377,2024-05-01,0,991,991
2378,378,2024-05-01,40817,1097,41914
2379,379,2024-05-01,33620,2489,36109
2380,380,2024-05-01,38802,2807,41609
2381,381,2024-05-01,14855,4780,19635
2382,382,2024-05-01,15527,1161,16688
2383,383,2024-05-01,45440,87,45527
2384,384,2024-05-01,33387,-4995,28392
2385,385,2024-05-01,25664,4081,29745
2386,386,2024-05-01,27684,3565,31249
2387,387,2024-05-01,26703,1204,27907
2388,388,2024-05-01,21268,1628,22896
2389,389,2024-05-01,14406,1015,15421
2390,390,2024-05-01,20299,2001,22300
2391,391,2024-05-01,37316,3229,40545
2392,392,2024-05-01,38160,3535,41695
2393,393,2024-05-01,13261,2742,16003
2394,394,2024-05-01,48079,2301,50380
2395,395,2024-05-01,39003,1823,40826
2396,396,2024-05-01,15877,4644,20521
2397,397,2024-05-01,0,4900,4900
2398,398,2024-05-01,33678,2678,36356
2399,399,2024-05-01,46942,60,47002
2400,400,2024-05-01,40274,3634,43908
2401,401,2024-05-01,17020,3442,20462
2402,402,2024-05-01,20990,2500,23490
2403,403,2024-05-01,17039,2143,19182
2404,404,2024-05-01,45222,153,45375
2405,405,2024-05-01,10747,663,11410
2406,406,2024-05-01,44244,1283,45527
2407,407,2024-05-01,44368,1460,45828
2408,408,2024-05-01,45583,793,46376
2409,409,2024-05-01,19105,1048,20153
2410,410,2024-05-01,21950,985,22935
2411,411,2024-05-01,26230,344,26574
2412,412,2024-05-01,38816,4536,43352
2413,413,2024-05-01,16519,2057,18576
2414,414,2024-05-01,44050,1354,45404
2415,415,2024-05-01,22932,1742,24674
2416,416,2024-05-01,32054,4775,36829
2417,417,2024-05-01,31572,855,32427
2418,418,2024-05-01,13992,4248,18240
2419,419,2024-05-01,49962,4049,54011
2420,420,2024-05-01,38639,593,39232
2421,421,2024-05-01,26868,3704,30572
2422,422,2024-05-01,28624,2502,31126
2423,423,2024-05-01,49601,4239,53840
2424,424,2024-05-01,16179,4703,20882
2425,425,2024-05-01,41211,1306,42517
2426,426,2024-05-01,13752,2676,16428
2427,427,2024-05-01,26557,4580,31137
2428,428,2024-05-01,34835,4029,38864
2429,429,2024-05-01,39279,1571,40850
2430,430,2024-05-01,0,1641,1641
2431,431,2024-05-01,24122,4092,28214
2432,432,2024-05-01,0,3254,3254
2433,433,2024-05-01,48481,3819,52300
2434,434,2024-05-01,36348,4124,40472
2435,435,2024-05-01,16650,2027,18677
2436,436,2024-05-01,17068,2490,19558
2437,437,2024-05-01,30985,3797,34782
2438,438,2024-05-01,36493,3328,39821
2439,439,2024-05-01,33378,4477,37855
2440,440,2024-05-01,19323,3092,22415
2441,441,2024-05-01,47064,1421,48485
2442,442,2024-05-01,17252,605,17857
2443,443,2024-05-01,48732,2442,51174
2444,444,2024-05-01,38465,4023,42488
2445,445,2024-05-01,33092,1040,34132
2446,446,2024-05-01,43057,2966,46023
2447,447,2024-05-01,21174,3765,24939
2448,448,2024-05-01,10596,2247,12843
2449,449,2024-05-01,47826,3803,51629
2450,450,2024-05-01,26583,3564,30147
2451,451,2024-05-01,21613,2790,24403
2452,452,2024-05-01,18038,2926,20964
2453,453,2024-05-01,35914,2805,38719
2454,454,2024-05-01,43965,2306,46271
2455,455,2024-05-01,30561,4710,35271
2456,456,2024-05-01,19294,4820,24114
2457,457,2024-05-01,29307,2932,32239
2458,458,2024-05-01,16053,2163,18216
2459,459,2024-05-01,13629,2245,15874
2460,460,2024-05-01,14324,1081,15405
2461,461,2024-05-01,46974,410,47384
2462,462,2024-05-01,23342,1345,24687
2463,463,2024-05-01,39952,2183,42135
2464,464,2024-05-01,24213,386,24599
2465,465,2024-05-01,28010,2795,30805
2466,466,2024-05-01,46567,4668,51235
2467,467,2024-05-01,35500,-3361,32139
2468,468,2024-05-01,47956,1393,49349
2469,469,2024-05-01,20941,1616,22557
2470,470,2024-05-01,29737,4824,34561
2471,471,2024-05-01,41663,1058,42721
2472,472,2024-05-01,45935,4478,50413
2473,473,2024-05-01,12994,3707,16701
2474,474,2024-05-01,19540,4105,23645
2475,475,2024-05-01,12368,4512,16880
2476,476,2024-05-01,34166,3163,37329
2477,477,2024-05-01,25232,636,25868
2478,478,2024-05-01,20992,1701,22693
2479,479,2024-05-01,17936,2239,20175
2480,480,2024-05-01,28739,1742,30481
2481,481,2024-05-01,18352,2813,21165
2482,482,2024-05-01,48502,2569,51071
2483,483,2024-05-01,36499,4014,40513
2484,484,2024-05-01,41202,3421,44623
2485,485,2024-05-01,45375,1912,47287
2486,486,2024-05-01,35737,1608,37345
2487,487,2024-05-01,45871,1344,47215
2488,488,2024-05-01,35944,4777,40721
2489,489,2024-05-01,10198,174,10372
2490,490,2024-05-01,26026,304,26330
2491,491,2024-05-01,25069,1030,26099
2492,492,2024-05-01,39788,3148,42936
2493,493,2024-05-01,29519,-1801,27718
2494,494,2024-05-01,29366,1097,30463
2495,495,2024-05-01,26266,398,26664
2496,496,2024-05-01,26966,3330,30296
2497,497,2024-05-01,39122,1347,40469
2498,498,2024-05-01,34320,275,34595
2499,499,2024-05-01,23351,1242,24593
2500,500,2024-05-01,19731,584,20315
2501,1,2024-06-01,20109,4654,24763
2502,2,2024-06-01,34842,3313,38155
2503,3,2024-06-01,29537,1216,30753
2504,4,2024-06-01,41336,4515,45851
2505,5,2024-06-01,27073,747,27820
2506,6,2024-06-01,24246,1640,25886
2507,7,2024-06-01,28353,3907,32260
2508,8,2024-06-01,10351,4337,14688
2509,9,2024-06-01,23891,1601,25492
2510,10,2024-06-01,20411,4265,24676
2511,11,2024-06-01,43551,4102,47653
2512,12,2024-06-01,47289,1353,48642
2513,13,2024-06-01,43126,1395,44521
2514,14,2024-06-01,41494,9,41503
2515,15,2024-06-01,22645,282,22927
2516,16,2024-06-01,48641,2988,51629
2517,17,2024-06-01,46149,1085,47234
2518,18,2024-06-01,48167,3983,52150
2519,19,2024-06-01,18990,2304,21294
2520,20,2024-06-01,15386,2267,17653
2521,21,2024-06-01,49265,1492,50757
2522,22,2024-06-01,15247,2092,17339
2523,23,2024-06-01,0,2091,2091
2524,24,2024-06-01,38498,194,38692
2525,25,2024-06-01,46823,2008,48831
2526,26,2024-06-01,13668,1713,15381
2527,27,2024-06-01,22192,1122,23314
2528,28,2024-06-01,12405,3465,15870
2529,29,2024-06-01,29359,3565,32924
2530,30,2024-06-01,44827,1958,46785
2531,31,2024-06-01,22632,586,23218
2532,32,2024-06-01,10469,259,10728
2533,33,2024-06-01,33410,4475,37885
2534,34,2024-06-01,45715,190,45905
2535,35,2024-06-01,19370,1609,20979
2536,36,2024-06-01,18576,1823,20399
2537,37,2024-06-01,14296,2082,16378
2538,38,2024-06-01,10020,605,10625
2539,39,2024-06-01,23636,1901,25537
2540,40,2024-06-01,12720,2343,15063
2541,41,2024-06-01,32188,3348,35536
2542,42,2024-06-01,30612,1871,32483
2543,43,2024-06-01,47020,2140,49160
2544,44,2024-06-01,28999,3493,32492
2545,45,2024-06-01,46546,1562,48108
2546,46,2024-06-01,20927,4063,24990
2547,47,2024-06-01,18774,-3317,15457
2548,48,2024-06-01,16850,532,17382
2549,49,2024-06-01,47084,3949,51033
2550,50,2024-06-01,28886,4609,33495
2551,51,2024-06-01,16942,336,17278
2552,52,2024-06-01,12149,2239,14388
2553,53,2024-06-01,45864,1880,47744
2554,54,2024-06-01,17010,2696,19706
2555,55,2024-06-01,24864,2232,27096
2556,56,2024-06-01,48154,137,48291
2557,57,2024-06-01,36831,2191,39022
2558,58,2024-06-01,27432,1281,28713
2559,59,2024-06-01,37748,3442,41190
2560,60,2024-06-01,43751,802,44553
2561,61,2024-06-01,23765,3321,27086
2562,62,2024-06-01,30896,1216,32112
2563,63,2024-06-01,31904,4249,36153
2564,64,2024-06-01,21080,1201,22281
2565,65,2024-06-01,25053,2599,27652
2566,66,2024-06-01,35687,-1945,33742
2567,67,2024-06-01,23724,-260,23464
2568,68,2024-06-01,49155,3793,52948
2569,69,2024-06-01,37897,1650,39547
2570,70,2024-06-01,30392,261,30653
2571,71,2024-06-01,25519,2496,28015
2572,72,2024-06-01,42809,998,43807
2573,73,2024-06-01,48377,4933,53310
2574,74,2024-06-01,29860,2724,32584
2575,75,2024-06-01,43708,484,44192
2576,76,2024-06-01,13361,1964,15325
2577,77,2024-06-01,25029,2316,27345
2578,78,2024-06-01,12892,2216,15108
2579,79,2024-06-01,28693,1167,29860
2580,80,2024-06-01,14217,27,14244
2581,81,2024-06-01,44744,1070,45814
2582,82,2024-06-01,11485,1406,12891
2583,83,2024-06-01,16777,4495,21272
2584,84,2024-06-01,21789,901,22690
2585,85,2024-06-01,16962,4827,21789
2586,86,2024-06-01,17087,934,18021
2587,87,2024-06-01,48533,1211,49744
2588,88,2024-06-01,46311,3996,50307
2589,89,2024-06-01,0,1016,1016
2590,90,2024-06-01,11919,88,12007
2591,91,2024-06-01,48341,2299,50640
2592,92,2024-06-01,19218,2922,22140
2593,93,2024-06-01,15263,3229,18492
2594,94,2024-06-01,34079,3446,37525
2595,95,2024-06-01,36439,3560,39999
2596,96,2024-06-01,21387,1625,23012
2597,97,2024-06-01,35288,2940,38228
2598,98,2024-06-01,44403,3004,47407
2599,99,2024-06-01,38236,3425,41661
2600,100,2024-06-01,15156,2013,17169
2601,101,2024-06-01,17122,2461,19583
2602,102,2024-06-01,46395,3540,49935
2603,103,2024-06-01,48240,4648,52888
2604,104,2024-06-01,44330,3379,47709
2605,105,2024-06-01,36796,226,37022
2606,106,2024-06-01,35360,2572,37932
2607,107,2024-06-01,25006,-4871,20135
2608,108,2024-06-01,0,2519,2519
2609,109,2024-06-01,43026,2957,45983
2610,110,2024-06-01,24162,2947,27109
2611,111,2024-06-01,37606,1432,39038
2612,112,2024-06-01,46038,4559,50597
2613,113,2024-06-01,45796,1121,46917
2614,114,2024-06-01,24394,2761,27155
2615,115,2024-06-01,29976,1956,31932
2616,116,2024-06-01,23643,2893,26536
2617,117,2024-06-01,24131,2867,26998
2618,118,2024-06-01,34714,3126,37840
2619,119,2024-06-01,35714,2017,37731
2620,120,2024-06-01,17580,2123,19703
2621,121,2024-06-01,36163,1067,37230
2622,122,2024-06-01,43236,273,43509
2623,123,2024-06-01,17180,838,18018
2624,124,2024-06-01,31805,4284,36089
2625,125,2024-06-01,11394,1821,13215
2626,126,2024-06-01,27692,452,28144
2627,127,2024-06-01,47108,3102,50210
2628,128,2024-06-01,35891,4557,40448
2629,129,2024-06-01,15346,54,15400
2630,130,2024-06-01,35694,3974,39668
2631,131,2024-06-01,10598,1136,11734
2632,132,2024-06-01,18922,1397,20319
2633,133,2024-06-01,11132,1395,12527
2634,134,2024-06-01,37004,2341,39345
2635,135,2024-06-01,33446,2889,36335
2636,136,2024-06-01,21950,2248,24198
2637,137,2024-06-01,33364,3498,36862
2638,138,2024-06-01,47398,877,48275
2639,139,2024-06-01,40969,3790,44759
2640,140,2024-06-01,34467,4767,39234
2641,141,2024-06-01,29551,4489,34040
2642,142,2024-06-01,37079,3911,40990
2643,143,2024-06-01,17781,4943,22724
2644,144,2024-06-01,16073,3002,19075
2645,145,2024-06-01,13385,2814,16199
2646,146,2024-06-01,13398,2885,16283
2647,147,2024-06-01,19217,-2748,16469
2648,148,2024-06-01,26531,4204,30735
2649,149,2024-06-01,20149,2734,22883
2650,150,2024-06-01,36557,1928,38485
2651,151,2024-06-01,19032,251,19283
2652,152,2024-06-01,36849,2913,39762
2653,153,2024-06-01,29528,4625,34153
2654,154,2024-06-01,20700,2462,23162
2655,155,2024-06-01,30898,3681,34579
2656,156,2024-06-01,29470,4977,34447
2657,157,2024-06-01,37370,433,37803
2658,158,2024-06-01,40632,4816,45448
2659,159,2024-06-01,0,3614,3614
2660,160,2024-06-01,20090,2081,22171
2661,161,2024-06-01,22293,1334,23627
2662,162,2024-06-01,22043,1361,23404
2663,163,2024-06-01,24730,4482,29212
2664,164,2024-06-01,22646,4274,26920
2665,165,2024-06-01,17055,3917,20972
2666,166,2024-06-01,33464,214,33678
2667,167,2024-06-01,48732,2455,51187
2668,168,2024-06-01,37745,2999,40744
2669,169,2024-06-01,25875,1541,27416
2670,170,2024-06-01,10657,4403,15060
2671,171,2024-06-01,44739,693,45432
2672,172,2024-06-01,23664,1424,25088
2673,173,2024-06-01,28696,1520,30216
2674,174,2024-06-01,35303,3244,38547
2675,175,2024-06-01,49041,2795,51836
2676,176,2024-06-01,23428,92,23520
2677,177,2024-06-01,19093,1576,20669
2678,178,2024-06-01,39501,336,39837
2679,179,2024-06-01,20537,1671,22208
2680,180,2024-06-01,24669,724,25393
2681,181,2024-06-01,10297,1997,12294
2682,182,2024-06-01,42347,1862,44209
2683,183,2024-06-01,49547,1612,51159
2684,184,2024-06-01,44057,2683,46740
2685,185,2024-06-01,43811,2093,45904
2686,186,2024-06-01,11820,4474,16294
2687,187,2024-06-01,29891,2318,32209
2688,188,2024-06-01,44849,4100,48949
2689,189,2024-06-01,20833,2529,23362
2690,190,2024-06-01,13049,4235,17284
2691,191,2024-06-01,40923,4280,45203
2692,192,2024-06-01,46330,134,46464
2693,193,2024-06-01,22911,2212,25123
2694,194,2024-06-01,41619,-3386,38233
2695,195,2024-06-01,10982,1804,12786
2696,196,2024-06-01,40586,786,41372
2697,197,2024-06-01,42242,1043,43285
2698,198,2024-06-01,48623,1780,50403
2699,199,2024-06-01,29862,3810,33672
2700,200,2024-06-01,23756,175,23931
2701,201,2024-06-01,28602,4243,32845
2702,202,2024-06-01,16623,1104,17727
2703,203,2024-06-01,33095,4214,37309
2704,204,2024-06-01,34634,1244,35878
2705,205,2024-06-01,13094,3276,16370
2706,206,2024-06-01,10041,1839,11880
2707,207,2024-06-01,16293,4288,20581
2708,208,2024-06-01,47638,5,47643
2709,209,2024-06-01,14732,2877,17609
2710,210,2024-06-01,29283,130,29413
2711,211,2024-06-01,21382,1956,23338
2712,212,2024-06-01,19093,4491,23584
2713,213,2024-06-01,41181,2307,43488
2714,214,2024-06-01,46518,3726,50244
2715,215,2024-06-01,20317,1119,21436
2716,216,2024-06-01,49070,1431,50501
2717,217,2024-06-01,34248,351,34599
2718,218,2024-06-01,20936,356,21292
2719,219,2024-06-01,23725,1487,25212
2720,220,2024-06-01,26199,4870,31069
2721,221,2024-06-01,11813,1318,13131
2722,222,2024-06-01,41342,-972,40370
2723,223,2024-06-01,16436,891,17327
2724,224,2024-06-01,28558,3503,32061
2725,225,2024-06-01,40005,4175,44180
2726,226,2024-06-01,29689,2610,32299
2727,227,2024-06-01,36868,2800,39668
2728,228,2024-06-01,12223,3735,15958
2729,229,2024-06-01,15862,2233,18095
2730,230,2024-06-01,11002,2672,13674
2731,231,2024-06-01,31329,3870,35199
2732,232,2024-06-01,23863,932,24795
2733,233,2024-06-01,26152,3689,29841
2734,234,2024-06-01,20421,2351,22772
2735,235,2024-06-01,26651,3479,30130
2736,236,2024-06-01,36042,1228,37270
2737,237,2024-06-01,45287,4788,50075
2738,238,2024-06-01,33105,2858,35963
2739,239,2024-06-01,31728,4018,35746
2740,240,2024-06-01,40084,2954,43038
2741,241,2024-06-01,23317,4817,28134
2742,242,2024-06-01,11404,3322,14726
2743,243,2024-06-01,29581,2235,31816
2744,244,2024-06-01,37414,2336,39750
2745,245,2024-06-01,12520,2039,14559
2746,246,2024-06-01,47595,132,47727
2747,247,2024-06-01,21610,713,22323
2748,248,2024-06-01,27290,-2741,24549
2749,249,2024-06-01,43961,6,43967
2750,250,2024-06-01,33688,2162,35850
2751,251,2024-06-01,48258,4819,53077
2752,252,2024-06-01,15187,913,16100
2753,253,2024-06-01,17341,1465,18806
2754,254,2024-06-01,29070,3222,32292
2755,255,2024-06-01,20915,1135,22050
2756,256,2024-06-01,32429,1595,34024
2757,257,2024-06-01,14313,954,15267
2758,258,2024-06-01,40907,981,41888
2759,259,2024-06-01,15705,3749,19454
2760,260,2024-06-01,45594,3388,48982
2761,261,2024-06-01,36671,4999,41670
2762,262,2024-06-01,23057,387,23444
2763,263,2024-06-01,37846,3387,41233
2764,264,2024-06-01,36328,4439,40767
2765,265,2024-06-01,23821,3958,27779
2766,266,2024-06-01,28501,2287,30788
2767,267,2024-06-01,18488,2637,21125
2768,268,2024-06-01,46145,4402,50547
2769,269,2024-06-01,35099,1418,36517
2770,270,2024-06-01,41133,3806,44939
2771,271,2024-06-01,36194,1119,37313
2772,272,2024-06-01,41567,3659,45226
2773,273,2024-06-01,41646,325,41971
2774,274,2024-06-01,30236,3730,33966
2775,275,2024-06-01,34052,4378,38430
2776,276,2024-06-01,25453,1251,26704
2777,277,2024-06-01,43190,3749,46939
2778,278,2024-06-01,21409,2732,24141
2779,279,2024-06-01,25263,3834,29097
2780,280,2024-06-01,24317,2846,27163
2781,281,2024-06-01,45637,790,46427
2782,282,2024-06-01,18587,2102,20689
2783,283,2024-06-01,29871,1629,31500
2784,284,2024-06-01,19797,1331,21128
2785,285,2024-06-01,14065,4579,18644
2786,286,2024-06-01,16142,2738,18880
2787,287,2024-06-01,23857,420,24277
2788,288,2024-06-01,20063,577,20640
2789,289,2024-06-01,18977,4206,23183
2790,290,2024-06-01,26667,2302,28969
2791,291,2024-06-01,16446,335,16781
2792,292,2024-06-01,17404,119,17523
2793,293,2024-06-01,42198,3840,46038
2794,294,2024-06-01,10538,3852,14390
2795,295,2024-06-01,14664,2815,17479
2796,296,2024-06-01,21005,3161,24166
2797,297,2024-06-01,19617,2520,22137
2798,298,2024-06-01,21346,3131,24477
2799,299,2024-06-01,43903,2821,46724
2800,300,2024-06-01,33266,2497,35763
2801,301,2024-06-01,28208,2538,30746
2802,302,2024-06-01,22859,1540,24399
2803,303,2024-06-01,10787,3273,14060
2804,304,2024-06-01,29113,2926,32039
2805,305,2024-06-01,10389,2655,13044
2806,306,2024-06-01,27010,1112,28122
2807,307,2024-06-01,47578,2180,49758
2808,308,2024-06-01,22670,98,22768
2809,309,2024-06-01,43305,4107,47412
2810,310,2024-06-01,30569,3138,33707
2811,311,2024-06-01,43560,846,44406
2812,312,2024-06-01,44081,3503,47584
2813,313,2024-06-01,21302,2126,23428
2814,314,2024-06-01,15135,3453,18588
2815,315,2024-06-01,17151,4954,22105
2816,316,2024-06-01,16974,2714,19688
2817,317,2024-06-01,38907,1345,40252
2818,318,2024-06-01,37154,600,37754
2819,319,2024-06-01,23201,2546,25747
2820,320,2024-06-01,46109,3653,49762
2821,321,2024-06-01,30269,1838,32107
2822,322,2024-06-01,45776,148,45924
2823,323,2024-06-01,10614,4193,14807
2824,324,2024-06-01,19760,4410,24170
2825,325,2024-06-01,13065,3221,16286
2826,326,2024-06-01,15820,3581,19401
2827,327,2024-06-01,42966,2188,45154
2828,328,2024-06-01,21837,2543,24380
2829,329,2024-06-01,22596,3659,26255
2830,330,2024-06-01,27755,4113,31868
2831,331,2024-06-01,31956,1800,33756
2832,332,2024-06-01,31009,4345,35354
2833,333,2024-06-01,24644,3139,27783
2834,334,2024-06-01,45962,3942,49904
2835,335,2024-06-01,44524,388,44912
2836,336,2024-06-01,16955,2294,19249
2837,337,2024-06-01,40069,1902,41971
2838,338,2024-06-01,10018,4724,14742
2839,339,2024-06-01,47735,2298,50033
2840,340,2024-06-01,44955,4235,49190
2841,341,2024-06-01,34696,2954,37650
2842,342,2024-06-01,17951,1028,18979
2843,343,2024-06-01,23230,1683,24913
2844,344,2024-06-01,34397,4046,38443
2845,345,2024-06-01,37507,1736,39243
2846,346,2024-06-01,16523,2726,19249
2847,347,2024-06-01,44619,606,45225
2848,348,2024-06-01,10808,4366,15174
2849,349,2024-06-01,28778,4529,33307
2850,350,2024-06-01,15752,4581,20333
2851,351,2024-06-01,43696,1508,45204
2852,352,2024-06-01,47544,1022,48566
2853,353,2024-06-01,26497,3126,29623
2854,354,2024-06-01,30319,2931,33250
2855,355,2024-06-01,21638,729,22367
2856,356,2024-06-01,48741,1892,50633
2857,357,2024-06-01,29109,3709,32818
2858,358,2024-06-01,36227,2133,38360
2859,359,2024-06-01,36244,307,36551
2860,360,2024-06-01,32434,2839,35273
2861,361,2024-06-01,30941,1148,32089
2862,362,2024-06-01,27187,1135,28322
2863,363,2024-06-01,25734,3222,28956
2864,364,2024-06-01,0,111,111
2865,365,2024-06-01,11728,560,12288
2866,366,2024-06-01,11210,1282,12492
2867,367,2024-06-01,10637,1260,11897
2868,368,2024-06-01,13701,1691,15392
2869,369,2024-06-01,23024,3553,26577
2870,370,2024-06-01,11622,2322,13944
2871,371,2024-06-01,16110,3794,19904
2872,372,2024-06-01,10744,4798,15542
2873,373,2024-06-01,46233,4064,50297
2874,374,2024-06-01,18015,458,18473
2875,375,2024-06-01,14712,2281,16993
2876,376,2024-06-01,26522,4062,30584
2877,377,2024-06-01,31287,942,32229
2878,378,2024-06-01,35420,1013,36433
2879,379,2024-06-01,43152,1316,44468
2880,380,2024-06-01,17703,2962,20665
2881,381,2024-06-01,12758,1311,14069
2882,382,2024-06-01,17063,-914,16149
2883,383,2024-06-01,40775,1479,42254
2884,384,2024-06-01,40218,1553,41771
2885,385,2024-06-01,47037,3375,50412
2886,386,2024-06-01,29305,616,29921
2887,387,2024-06-01,10057,1563,11620
2888,388,2024-06-01,18814,2808,21622
2889,389,2024-06-01,15583,2626,18209
2890,390,2024-06-01,17551,3109,20660
2891,391,2024-06-01,14922,716,15638
2892,392,2024-06-01,11816,654,12470
2893,393,2024-06-01,38221,2599,40820
2894,394,2024-06-01,15549,244,15793
2895,395,2024-06-01,35636,4946,40582
2896,396,2024-06-01,40022,2082,42104
2897,397,2024-06-01,29977,3,29980
2898,398,2024-06-01,24147,1338,25485
2899,399,2024-06-01,47559,429,47988
2900,400,2024-06-01,0,3373,3373
2901,401,2024-06-01,31818,4056,35874
2902,402,2024-06-01,25231,4721,29952
2903,403,2024-06-01,18976,387,19363
2904,404,2024-06-01,11390,2728,14118
2905,405,2024-06-01,12225,3369,15594
2906,406,2024-06-01,15470,2549,18019
2907,407,2024-06-01,32780,504,33284
2908,408,2024-06-01,31026,4253,35279
2909,409,2024-06-01,30241,4471,34712
2910,410,2024-06-01,26816,4887,31703
2911,411,2024-06-01,22672,4427,27099
2912,412,2024-06-01,49063,28,49091
2913,413,2024-06-01,43453,2338,45791
2914,414,2024-06-01,13335,2963,16298
2915,415,2024-06-01,44304,1431,45735
2916,416,2024-06-01,25585,3239,28824
2917,417,2024-06-01,41377,34,41411
2918,418,2024-06-01,0,1264,1264
2919,419,2024-06-01,22051,3126,25177
2920,420,2024-06-01,27815,1415,29230
2921,421,2024-06-01,32132,1362,33494
2922,422,2024-06-01,16525,475,17000
2923,423,2024-06-01,34975,957,35932
2924,424,2024-06-01,33539,1547,35086
2925,425,2024-06-01,14246,4739,18985
2926,426,2024-06-01,42723,4147,46870
2927,427,2024-06-01,13543,1295,14838
2928,428,2024-06-01,28719,1629,30348
2929,429,2024-06-01,14408,173,14581
2930,430,2024-06-01,26357,2388,28745
2931,431,2024-06-01,20703,-3511,17192
2932,432,2024-06-01,48916,2610,51526
2933,433,2024-06-01,22916,2832,25748
2934,434,2024-06-01,41972,1666,43638
2935,435,2024-06-01,47597,3115,50712
2936,436,2024-06-01,13677,4330,18007
2937,437,2024-06-01,27697,2309,30006
2938,438,2024-06-01,29293,59,29352
2939,439,2024-06-01,16471,2941,19412
2940,440,2024-06-01,11506,244,11750
2941,441,2024-06-01,23335,4191,27526
2942,442,2024-06-01,19289,3424,22713
2943,443,2024-06-01,13069,4342,17411
2944,444,2024-06-01,16511,3252,19763
2945,445,2024-06-01,44290,2759,47049
2946,446,2024-06-01,12607,2847,15454
2947,447,2024-06-01,0,-948,-948
2948,448,2024-06-01,13820,3155,16975
2949,449,2024-06-01,30252,235,30487
2950,450,2024-06-01,16442,1786,18228
2951,451,2024-06-01,37360,2911,40271
2952,452,2024-06-01,15533,-542,14991
2953,453,2024-06-01,46687,-3251,43436
2954,454,2024-06-01,30732,4722,35454
2955,455,2024-06-01,0,2315,2315
2956,456,2024-06-01,17957,4693,22650
2957,457,2024-06-01,46581,3348,49929
2958,458,2024-06-01,29859,1556,31415
2959,459,2024-06-01,42633,518,43151
2960,460,2024-06-01,32420,2256,34676
2961,461,2024-06-01,35212,1073,36285
2962,462,2024-06-01,10982,1230,12212
2963,463,2024-06-01,13585,3605,17190
2964,464,2024-06-01,35209,702,35911
2965,465,2024-06-01,20190,287,20477
2966,466,2024-06-01,18545,4257,22802
2967,467,2024-06-01,13660,275,13935
2968,468,2024-06-01,47108,4006,51114
2969,469,2024-06-01,27545,853,28398
2970,470,2024-06-01,20485,4408,24893
2971,471,2024-06-01,28016,1904,29920
2972,472,2024-06-01,25799,1515,27314
2973,473,2024-06-01,30508,1331,31839
2974,474,2024-06-01,26349,216,26565
2975,475,2024-06-01,16118,3675,19793
2976,476,2024-06-01,34796,4135,38931
2977,477,2024-06-01,45988,450,46438
2978,478,2024-06-01,47304,3911,51215
2979,479,2024-06-01,39846,107,39953
2980,480,2024-06-01,16714,2660,19374
2981,481,2024-06-01,43247,1086,44333
2982,482,2024-06-01,34027,3791,37818
2983,483,2024-06-01,34653,4340,38993
2984,484,2024-06-01,18252,3306,21558
2985,485,2024-06-01,47813,1614,49427
2986,486,2024-06-01,37422,2609,40031
2987,487,2024-06-01,29944,1680,31624
2988,488,2024-06-01,38618,3673,42291
2989,489,2024-06-01,47467,859,48326
2990,490,2024-06-01,25892,842,26734
2991,491,2024-06-01,17460,3904,21364
2992,492,2024-06-01,25977,1386,27363
2993,493,2024-06-01,35984,270,36254
2994,494,2024-06-01,21886,3688,25574
2995,495,2024-06-01,19519,366,19885
2996,496,2024-06-01,45594,899,46493
2997,497,2024-06-01,47928,1454,49382
2998,498,2024-06-01,12118,1764,13882
2999,499,2024-06-01,12115,242,12357
3000,500,2024-06-01,13898,3059,16957
3001,1,2024-07-01,17334,2039,19373
3002,2,2024-07-01,19889,3100,22989
3003,3,2024-07-01,40719,4202,44921
3004,4,2024-07-01,18706,706,19412
3005,5,2024-07-01,26069,2835,28904
3006,6,2024-07-01,11910,4248,16158
3007,7,2024-07-01,43474,2474,45948
3008,8,2024-07-01,24243,1775,26018
3009,9,2024-07-01,0,259,259
3010,10,2024-07-01,24977,2078,27055
3011,11,2024-07-01,23688,3436,27124
3012,12,2024-07-01,40992,426,41418
3013,13,2024-07-01,14512,3940,18452
3014,14,2024-07-01,39369,290,39659
3015,15,2024-07-01,28013,1387,29400
3016,16,2024-07-01,33737,3918,37655
3017,17,2024-07-01,42212,16,42228
3018,18,2024-07-01,47208,926,48134
3019,19,2024-07-01,20145,1400,21545
3020,20,2024-07-01,26149,4313,30462
3021,21,2024-07-01,44033,2594,46627
3022,22,2024-07-01,15721,4580,20301
3023,23,2024-07-01,19061,2614,21675
3024,24,2024-07-01,0,-602,-602
3025,25,2024-07-01,47871,1262,49133
3026,26,2024-07-01,31005,2475,33480
3027,27,2024-07-01,0,448,448
3028,28,2024-07-01,19461,3932,23393
3029,29,2024-07-01,30365,1444,31809
3030,30,2024-07-01,36983,522,37505
3031,31,2024-07-01,19624,4434,24058
3032,32,2024-07-01,29497,2845,32342
3033,33,2024-07-01,12438,2382,14820
3034,34,2024-07-01,48513,4681,53194
3035,35,2024-07-01,46030,3651,49681
3036,36,2024-07-01,41824,4864,46688
3037,37,2024-07-01,22416,1097,23513
3038,38,2024-07-01,43355,3348,46703
3039,39,2024-07-01,30081,881,30962
3040,40,2024-07-01,29847,3800,33647
3041,41,2024-07-01,24342,1563,25905
3042,42,2024-07-01,29513,4190,33703
3043,43,2024-07-01,16141,1642,17783
3044,44,2024-07-01,48023,4269,52292
3045,45,2024-07-01,28631,2334,30965
3046,46,2024-07-01,36776,4566,41342
3047,47,2024-07-01,13620,149,13769
3048,48,2024-07-01,42936,3875,46811
3049,49,2024-07-01,0,1011,1011
3050,50,2024-07-01,35410,2584,37994
3051,51,2024-07-01,19538,1345,20883
3052,52,2024-07-01,10341,1500,11841
3053,53,2024-07-01,41657,2211,43868
3054,54,2024-07-01,15063,3201,18264
3055,55,2024-07-01,22551,1813,24364
3056,56,2024-07-01,47419,1320,48739
3057,57,2024-07-01,28425,1340,29765
3058,58,2024-07-01,28194,4881,33075
3059,59,2024-07-01,17992,2505,20497
3060,60,2024-07-01,18226,3683,21909
3061,61,2024-07-01,29439,4575,34014
3062,62,2024-07-01,18220,2137,20357
3063,63,2024-07-01,37973,3736,41709
3064,64,2024-07-01,0,2839,2839
3065,65,2024-07-01,16637,729,17366
3066,66,2024-07-01,48258,2922,51180
3067,67,2024-07-01,29242,4534,33776
3068,68,2024-07-01,11159,4325,15484
3069,69,2024-07-01,37690,3343,41033
3070,70,2024-07-01,48433,3608,52041
3071,71,2024-07-01,18805,2948,21753
3072,72,2024-07-01,0,4615,4615
3073,73,2024-07-01,20583,909,21492
3074,74,2024-07-01,39563,1361,40924
3075,75,2024-07-01,38903,4209,43112
3076,76,2024-07-01,23822,210,24032
3077,77,2024-07-01,39858,3073,42931
3078,78,2024-07-01,35655,4249,39904
3079,79,2024-07-01,24955,4765,29720
3080,80,2024-07-01,43645,3585,47230
3081,81,2024-07-01,31743,2478,34221
3082,82,2024-07-01,43680,3931,47611
3083,83,2024-07-01,15741,3419,19160
3084,84,2024-07-01,15383,4145,19528
3085,85,2024-07-01,22697,3242,25939
3086,86,2024-07-01,15111,3337,18448
3087,87,2024-07-01,18546,2223,20769
3088,88,2024-07-01,48721,445,49166
3089,89,2024-07-01,43832,3188,47020
3090,90,2024-07-01,18208,884,19092
3091,91,2024-07-01,32602,64,32666
3092,92,2024-07-01,48721,1444,50165
3093,93,2024-07-01,45172,555,45727
3094,94,2024-07-01,26914,3605,30519
3095,95,2024-07-01,38883,4394,43277
3096,96,2024-07-01,23430,2478,25908
3097,97,2024-07-01,33315,1987,35302
3098,98,2024-07-01,34857,2312,37169
3099,99,2024-07-01,37923,3782,41705
3100,100,2024-07-01,46645,3249,49894
3101,101,2024-07-01,29874,4901,34775
3102,102,2024-07-01,45179,2235,47414
3103,103,2024-07-01,44586,1266,45852
3104,104,2024-07-01,12362,2473,14835
3105,105,2024-07-01,33220,3115,36335
3106,106,2024-07-01,46981,4424,51405
3107,107,2024-07-01,20470,825,21295
3108,108,2024-07-01,37064,3084,40148
3109,109,2024-07-01,28309,126,28435
3110,110,2024-07-01,22330,3859,26189
3111,111,2024-07-01,15533,1001,16534
3112,112,2024-07-01,24209,2505,26714
3113,113,2024-07-01,49303,59,49362
3114,114,2024-07-01,16792,3148,19940
3115,115,2024-07-01,48755,4099,52854
3116,116,2024-07-01,17308,725,18033
3117,117,2024-07-01,37484,1023,38507
3118,118,2024-07-01,12979,2466,15445
3119,119,2024-07-01,15889,1753,17642
3120,120,2024-07-01,34146,1940,36086
3121,121,2024-07-01,25448,1682,27130
3122,122,2024-07-01,34489,1749,36238
3123,123,2024-07-01,36886,3277,40163
3124,124,2024-07-01,12537,3470,16007
3125,125,2024-07-01,20753,424,21177
3126,126,2024-07-01,13592,2367,15959
3127,127,2024-07-01,32635,-4238,28397
3128,128,2024-07-01,29470,4625,34095
3129,129,2024-07-01,29779,40,29819
3130,130,2024-07-01,33804,4188,37992
3131,131,2024-07-01,18343,3620,21963
3132,132,2024-07-01,29137,4579,33716
3133,133,2024-07-01,39265,158,39423
3134,134,2024-07-01,42815,1109,43924
3135,135,2024-07-01,12169,1659,13828
3136,136,2024-07-01,31385,2985,34370
3137,137,2024-07-01,24100,580,24680
3138,138,2024-07-01,20387,608,20995
3139,139,2024-07-01,33748,4328,38076
3140,140,2024-07-01,14663,3891,18554
3141,141,2024-07-01,37129,3803,40932
3142,142,2024-07-01,15138,1354,16492
3143,143,2024-07-01,17429,4697,22126
3144,144,2024-07-01,49072,3305,52377
3145,145,2024-07-01,19122,1275,20397
3146,146,2024-07-01,20905,215,21120
3147,147,2024-07-01,45893,2096,47989
3148,148,2024-07-01,22085,2559,24644
3149,149,2024-07-01,31549,1869,33418
3150,150,2024-07-01,47316,2758,50074
3151,151,2024-07-01,40186,1914,42100
3152,152,2024-07-01,43204,2175,45379
3153,153,2024-07-01,41760,1060,42820
3154,154,2024-07-01,37570,1755,39325
3155,155,2024-07-01,16491,3737,20228
3156,156,2024-07-01,16363,1717,18080
3157,157,2024-07-01,31891,1286,33177
3158,158,2024-07-01,45641,3453,49094
3159,159,2024-07-01,29416,4927,34343
3160,160,2024-07-01,23262,1738,25000
3161,161,2024-07-01,22571,3878,26449
3162,162,2024-07-01,21180,1429,22609
3163,163,2024-07-01,45581,1576,47157
3164,164,2024-07-01,22039,4810,26849
3165,165,2024-07-01,37366,3538,40904
3166,166,2024-07-01,48199,2202,50401
3167,167,2024-07-01,34568,2857,37425
3168,168,2024-07-01,41932,4429,46361
3169,169,2024-07-01,14235,853,15088
3170,170,2024-07-01,46944,3962,50906
3171,171,2024-07-01,30888,2597,33485
3172,172,2024-07-01,23685,947,24632
3173,173,2024-07-01,30435,1446,31881
3174,174,2024-07-01,28164,2846,31010
3175,175,2024-07-01,42828,2793,45621
3176,176,2024-07-01,11170,4221,15391
3177,177,2024-07-01,25100,1260,26360
3178,178,2024-07-01,23854,242,24096
3179,179,2024-07-01,23256,3131,26387
3180,180,2024-07-01,42423,3690,46113
3181,181,2024-07-01,31727,3970,35697
3182,182,2024-07-01,22212,666,22878
3183,183,2024-07-01,32471,2939,35410
3184,184,2024-07-01,39388,-3236,36152
3185,185,2024-07-01,22269,1591,23860
3186,186,2024-07-01,45382,2586,47968
3187,187,2024-07-01,47759,198,47957
3188,188,2024-07-01,29796,3270,33066
3189,189,2024-07-01,15201,2841,18042
3190,190,2024-07-01,32481,2939,35420
3191,191,2024-07-01,34628,2744,37372
3192,192,2024-07-01,23197,2519,25716
3193,193,2024-07-01,30472,1347,31819
3194,194,2024-07-01,34244,4192,38436
3195,195,2024-07-01,11441,4662,16103
3196,196,2024-07-01,42552,3372,45924
3197,197,2024-07-01,27190,2399,29589
3198,198,2024-07-01,10356,4705,15061
3199,199,2024-07-01,22363,2716,25079
3200,200,2024-07-01,27051,1885,28936
3201,201,2024-07-01,31794,3377,35171
3202,202,2024-07-01,25682,817,26499
3203,203,2024-07-01,29942,829,30771
3204,204,2024-07-01,43029,566,43595
3205,205,2024-07-01,43494,4644,48138
3206,206,2024-07-01,12941,3534,16475
3207,207,2024-07-01,25220,476,25696
3208,208,2024-07-01,23919,2114,26033
3209,209,2024-07-01,45052,4417,49469
3210,210,2024-07-01,22682,1436,24118
3211,211,2024-07-01,13260,2139,15399
3212,212,2024-07-01,33632,2255,35887
3213,213,2024-07-01,49873,2411,52284
3214,214,2024-07-01,15085,2167,17252
3215,215,2024-07-01,18751,4598,23349
3216,216,2024-07-01,46116,2111,48227
3217,217,2024-07-01,30673,3435,34108
3218,218,2024-07-01,28015,4227,32242
3219,219,2024-07-01,24507,3406,27913
3220,220,2024-07-01,42804,594,43398
3221,221,2024-07-01,20166,2227,22393
3222,222,2024-07-01,36181,2328,38509
3223,223,2024-07-01,41139,661,41800
3224,224,2024-07-01,27376,1492,28868
3225,225,2024-07-01,29171,4419,33590
3226,226,2024-07-01,42086,2794,44880
3227,227,2024-07-01,23537,658,24195
3228,228,2024-07-01,21481,1779,23260
3229,229,2024-07-01,38454,2261,40715
3230,230,2024-07-01,47684,61,47745
3231,231,2024-07-01,16113,-3648,12465
3232,232,2024-07-01,26302,1506,27808
3233,233,2024-07-01,19299,3728,23027
3234,234,2024-07-01,31957,627,32584
3235,235,2024-07-01,27769,2659,30428
3236,236,2024-07-01,48061,2625,50686
3237,237,2024-07-01,22212,2957,25169
3238,238,2024-07-01,37519,3416,40935
3239,239,2024-07-01,16046,2894,18940
3240,240,2024-07-01,45791,237,46028
3241,241,2024-07-01,22873,3194,26067
3242,242,2024-07-01,28358,4061,32419
3243,243,2024-07-01,27118,3651,30769
3244,244,2024-07-01,48149,2092,50241
3245,245,2024-07-01,46301,838,47139
3246,246,2024-07-01,37035,2014,39049
3247,247,2024-07-01,14229,4916,19145
3248,248,2024-07-01,20561,4982,25543
3249,249,2024-07-01,20235,1485,21720
3250,250,2024-07-01,15950,362,16312
3251,251,2024-07-01,14521,653,15174
3252,252,2024-07-01,17764,146,17910
3253,253,2024-07-01,0,310,310
3254,254,2024-07-01,37006,1363,38369
3255,255,2024-07-01,35767,1335,37102
3256,256,2024-07-01,48469,8,48477
3257,257,2024-07-01,36282,1472,37754
3258,258,2024-07-01,16926,250,17176
3259,259,2024-07-01,34678,3340,38018
3260,260,2024-07-01,37716,984,38700
3261,261,2024-07-01,27071,865,27936
3262,262,2024-07-01,30108,2164,32272
3263,263,2024-07-01,26308,-3586,22722
3264,264,2024-07-01,19997,2044,22041
3265,265,2024-07-01,22237,2298,24535
3266,266,2024-07-01,14164,4034,18198
3267,267,2024-07-01,19223,3150,22373
3268,268,2024-07-01,35533,1124,36657
3269,269,2024-07-01,20359,2057,22416
3270,270,2024-07-01,29281,3475,32756
3271,271,2024-07-01,40524,2781,43305
3272,272,2024-07-01,0,1031,1031
3273,273,2024-07-01,12279,1489,13768
3274,274,2024-07-01,20667,1489,22156
3275,275,2024-07-01,44649,588,45237
3276,276,2024-07-01,32864,397,33261
3277,277,2024-07-01,34181,3260,37441
3278,278,2024-07-01,49943,2519,52462
3279,279,2024-07-01,42045,4215,46260
3280,280,2024-07-01,46816,2949,49765
3281,281,2024-07-01,24807,4799,29606
3282,282,2024-07-01,30779,48,30827
3283,283,2024-07-01,23112,3947,27059
3284,284,2024-07-01,18007,3126,21133
3285,285,2024-07-01,29243,3480,32723
3286,286,2024-07-01,23442,488,23930
3287,287,2024-07-01,42323,4257,46580
3288,288,2024-07-01,38891,-240,38651
3289,289,2024-07-01,23853,1906,25759
3290,290,2024-07-01,43774,3855,47629
3291,291,2024-07-01,33447,3698,37145
3292,292,2024-07-01,27753,894,28647
3293,293,2024-07-01,32758,3103,35861
3294,294,2024-07-01,39308,669,39977
3295,295,2024-07-01,31890,308,32198
3296,296,2024-07-01,11734,4628,16362
3297,297,2024-07-01,12009,3796,15805
3298,298,2024-07-01,29831,1537,31368
3299,299,2024-07-01,46661,2180,48841
3300,300,2024-07-01,47370,1473,48843
3301,301,2024-07-01,19698,281,19979
3302,302,2024-07-01,22149,1153,23302
3303,303,2024-07-01,40521,673,41194
3304,304,2024-07-01,43551,35,43586
3305,305,2024-07-01,47657,4832,52489
3306,306,2024-07-01,24740,2212,26952
3307,307,2024-07-01,30312,4056,34368
3308,308,2024-07-01,12098,429,12527
3309,309,2024-07-01,46620,4424,51044
3310,310,2024-07-01,28825,3262,32087
3311,311,2024-07-01,40874,1733,42607
3312,312,2024-07-01,14805,2481,17286
3313,313,2024-07-01,25903,221,26124
3314,314,2024-07-01,47619,4688,52307
3315,315,2024-07-01,16401,101,16502
3316,316,2024-07-01,42393,3158,45551
3317,317,2024-07-01,28338,4422,32760
3318,318,2024-07-01,35219,2765,37984
3319,319,2024-07-01,27386,2434,29820
3320,320,2024-07-01,21084,3549,24633
3321,321,2024-07-01,44892,4805,49697
3322,322,2024-07-01,26120,4609,30729
3323,323,2024-07-01,46694,1260,47954
3324,324,2024-07-01,49553,4539,54092
3325,325,2024-07-01,47649,2258,49907
3326,326,2024-07-01,31545,2871,34416
3327,327,2024-07-01,40097,3207,43304
3328,328,2024-07-01,41800,1398,43198
3329,329,2024-07-01,15495,1233,16728
3330,330,2024-07-01,39231,25,39256
3331,331,2024-07-01,11274,2139,13413
3332,332,2024-07-01,13934,3277,17211
3333,333,2024-07-01,38706,2453,41159
3334,334,2024-07-01,49900,4886,54786
3335,335,2024-07-01,40207,3109,43316
3336,336,2024-07-01,12003,2262,14265
3337,337,2024-07-01,16871,3277,20148
3338,338,2024-07-01,18152,1275,19427
3339,339,2024-07-01,29342,3297,32639
3340,340,2024-07-01,31348,4451,35799
3341,341,2024-07-01,49587,2466,52053
3342,342,2024-07-01,19520,1003,20523
3343,343,2024-07-01,35886,2660,38546
3344,344,2024-07-01,31890,282,32172
3345,345,2024-07-01,44675,1626,46301
3346,346,2024-07-01,44082,4843,48925
3347,347,2024-07-01,28036,1184,29220
3348,348,2024-07-01,49111,3329,52440
3349,349,2024-07-01,26649,2413,29062
3350,350,2024-07-01,17512,2252,19764
3351,351,2024-07-01,0,2655,2655
3352,352,2024-07-01,43065,555,43620
3353,353,2024-07-01,16428,-1619,14809
3354,354,2024-07-01,11285,2704,13989
3355,355,2024-07-01,14040,3657,17697
3356,356,2024-07-01,41271,4982,46253
3357,357,2024-07-01,22004,3907,25911
3358,358,2024-07-01,33111,3227,36338
3359,359,2024-07-01,37576,4640,42216
3360,360,2024-07-01,12646,3726,16372
3361,361,2024-07-01,24816,3799,28615
3362,362,2024-07-01,13516,467,13983
3363,363,2024-07-01,46543,572,47115
3364,364,2024-07-01,10852,819,11671
3365,365,2024-07-01,21172,1475,22647
3366,366,2024-07-01,44556,4582,49138
3367,367,2024-07-01,40557,3839,44396
3368,368,2024-07-01,23744,3015,26759
3369,369,2024-07-01,14686,1900,16586
3370,370,2024-07-01,30931,4182,35113
3371,371,2024-07-01,27866,3205,31071
3372,372,2024-07-01,42189,543,42732
3373,373,2024-07-01,45288,3283,48571
3374,374,2024-07-01,24689,591,25280
3375,375,2024-07-01,16890,3784,20674
3376,376,2024-07-01,23298,2344,25642
3377,377,2024-07-01,12158,1498,13656
3378,378,2024-07-01,10361,-566,9795
3379,379,2024-07-01,37830,1603,39433
3380,380,2024-07-01,32142,4405,36547
3381,381,2024-07-01,29357,1276,30633
3382,382,2024-07-01,19286,2714,22000
3383,383,2024-07-01,23906,1172,25078
3384,384,2024-07-01,10165,3723,13888
3385,385,2024-07-01,27896,4396,32292
3386,386,2024-07-01,0,-4800,-4800
3387,387,2024-07-01,14901,1310,16211
3388,388,2024-07-01,0,3695,3695
3389,389,2024-07-01,20060,3748,23808
3390,390,2024-07-01,34612,1279,35891
3391,391,2024-07-01,48703,376,49079
3392,392,2024-07-01,25207,205,25412
3393,393,2024-07-01,40025,54,40079
3394,394,2024-07-01,43220,4505,47725
3395,395,2024-07-01,36070,738,36808
3396,396,2024-07-01,15407,1117,16524
3397,397,2024-07-01,22599,3486,26085
3398,398,2024-07-01,27144,2316,29460
3399,399,2024-07-01,21053,1276,22329
3400,400,2024-07-01,43749,3837,47586
3401,401,2024-07-01,28286,1361,29647
3402,402,2024-07-01,33788,2762,36550
3403,403,2024-07-01,33358,4238,37596
3404,404,2024-07-01,36059,1752,37811
3405,405,2024-07-01,28370,4080,32450
3406,406,2024-07-01,40926,3811,44737
3407,407,2024-07-01,31369,2232,33601
3408,408,2024-07-01,38682,3899,42581
3409,409,2024-07-01,26735,1789,28524
3410,410,2024-07-01,11515,3859,15374
3411,411,2024-07-01,27539,4898,32437
3412,412,2024-07-01,34630,3398,38028
3413,413,2024-07-01,13053,1225,14278
3414,414,2024-07-01,39614,142,39756
3415,415,2024-07-01,15662,3911,19573
3416,416,2024-07-01,28547,4109,32656
3417,417,2024-07-01,14607,2382,16989
3418,418,2024-07-01,23692,1693,25385
3419,419,2024-07-01,37004,1528,38532
3420,420,2024-07-01,43055,4199,47254
3421,421,2024-07-01,43718,-2234,41484
3422,422,2024-07-01,18565,2435,21000
3423,423,2024-07-01,45010,1680,46690
3424,424,2024-07-01,27824,4834,32658
3425,425,2024-07-01,47425,2925,50350
3426,426,2024-07-01,10187,3717,13904
3427,427,2024-07-01,36023,680,36703
3428,428,2024-07-01,42201,1667,43868
3429,429,2024-07-01,27149,2121,29270
3430,430,2024-07-01,10213,2876,13089
3431,431,2024-07-01,26024,2247,28271
3432,432,2024-07-01,31825,4439,36264
3433,433,2024-07-01,46751,2473,49224
3434,434,2024-07-01,14436,2201,16637
3435,435,2024-07-01,48770,4482,53252
3436,436,2024-07-01,24225,4575,28800
3437,437,2024-07-01,18932,3615,22547
3438,438,2024-07-01,20277,1730,22007
3439,439,2024-07-01,10802,3907,14709
3440,440,2024-07-01,31180,542,31722
3441,441,2024-07-01,35184,1553,36737
3442,442,2024-07-01,47625,3789,51414
3443,443,2024-07-01,30837,3974,34811
3444,444,2024-07-01,27049,361,27410
3445,445,2024-07-01,39225,384,39609
3446,446,2024-07-01,47677,-3706,43971
3447,447,2024-07-01,31996,601,32597
3448,448,2024-07-01,32174,1800,33974
3449,449,2024-07-01,31849,1204,33053
3450,450,2024-07-01,17008,2141,19149
3451,451,2024-07-01,10695,1704,12399
3452,452,2024-07-01,23333,2207,25540
3453,453,2024-07-01,42887,1169,44056
3454,454,2024-07-01,44693,1088,45781
3455,455,2024-07-01,16092,3015,19107
3456,456,2024-07-01,12661,267,12928
3457,457,2024-07-01,11142,100,11242
3458,458,2024-07-01,37090,4595,41685
3459,459,2024-07-01,43799,1967,45766
3460,460,2024-07-01,47863,2900,50763
3461,461,2024-07-01,20115,4825,24940
3462,462,2024-07-01,18370,2246,20616
3463,463,2024-07-01,26558,3343,29901
3464,464,2024-07-01,11827,2561,14388
3465,465,2024-07-01,11331,3024,14355
3466,466,2024-07-01,21520,4341,25861
3467,467,2024-07-01,40524,1758,42282
3468,468,2024-07-01,21812,3903,25715
3469,469,2024-07-01,44021,241,44262
3470,470,2024-07-01,26471,2069,28540
3471,471,2024-07-01,41181,1773,42954
3472,472,2024-07-01,10270,2716,12986
3473,473,2024-07-01,17154,-2323,14831
3474,474,2024-07-01,26501,1703,28204
3475,475,2024-07-01,46217,702,46919
3476,476,2024-07-01,25127,1223,26350
3477,477,2024-07-01,30683,528,31211
3478,478,2024-07-01,42684,359,43043
3479,479,2024-07-01,17241,2414,19655
3480,480,2024-07-01,35410,1806,37216
3481,481,2024-07-01,32493,771,33264
3482,482,2024-07-01,32022,1712,33734
3483,483,2024-07-01,18727,172,18899
3484,484,2024-07-01,33332,884,34216
3485,485,2024-07-01,36602,2331,38933
3486,486,2024-07-01,33349,2669,36018
3487,487,2024-07-01,31123,1779,32902
3488,488,2024-07-01,46675,3793,50468
3489,489,2024-07-01,45918,985,46903
3490,490,2024-07-01,42662,4818,47480
3491,491,2024-07-01,18644,1416,20060
3492,492,2024-07-01,46948,4497,51445
3493,493,2024-07-01,34498,2237,36735
3494,494,2024-07-01,11230,2930,14160
3495,495,2024-07-01,46026,4645,50671
3496,496,2024-07-01,11428,2558,13986
3497,497,2024-07-01,34209,2350,36559
3498,498,2024-07-01,0,1231,1231
3499,499,2024-07-01,18799,-2728,16071
3500,500,2024-07-01,39509,101,39610
3501,1,2024-08-01,39647,1460,41107
3502,2,2024-08-01,17853,3053,20906
3503,3,2024-08-01,25712,4324,30036
3504,4,2024-08-01,37563,4198,41761
3505,5,2024-08-01,14604,900,15504
3506,6,2024-08-01,37087,4946,42033
3507,7,2024-08-01,17289,1747,19036
3508,8,2024-08-01,36176,996,37172
3509,9,2024-08-01,38504,3875,42379
3510,10,2024-08-01,29357,489,29846
3511,11,2024-08-01,44573,4450,49023
3512,12,2024-08-01,35669,4658,40327
3513,13,2024-08-01,24659,964,25623
3514,14,2024-08-01,35170,4516,39686
3515,15,2024-08-01,18365,3673,22038
3516,16,2024-08-01,19796,2775,22571
3517,17,2024-08-01,21490,619,22109
3518,18,2024-08-01,41891,3537,45428
3519,19,2024-08-01,13847,2583,16430
3520,20,2024-08-01,49979,1786,51765
3521,21,2024-08-01,13036,3795,16831
3522,22,2024-08-01,21229,1063,22292
3523,23,2024-08-01,49853,2641,52494
3524,24,2024-08-01,16017,1992,18009
3525,25,2024-08-01,11172,1436,12608
3526,26,2024-08-01,48783,4632,53415
3527,27,2024-08-01,33551,1596,35147
3528,28,2024-08-01,10489,4026,14515
3529,29,2024-08-01,34809,-1477,33332
3530,30,2024-08-01,12685,2167,14852
3531,31,2024-08-01,38949,3427,42376
3532,32,2024-08-01,44257,4975,49232
3533,33,2024-08-01,22272,3485,25757
3534,34,2024-08-01,29190,2468,31658
3535,35,2024-08-01,31499,116,31615
3536,36,2024-08-01,14444,2045,16489
3537,37,2024-08-01,41524,45,41569
3538,38,2024-08-01,46323,2879,49202
3539,39,2024-08-01,39850,2058,41908
3540,40,2024-08-01,29919,4255,34174
3541,41,2024-08-01,17069,3265,20334
3542,42,2024-08-01,12192,353,12545
3543,43,2024-08-01,37638,2493,40131
3544,44,2024-08-01,14152,1829,15981
3545,45,2024-08-01,27342,725,28067
3546,46,2024-08-01,41033,1592,42625
3547,47,2024-08-01,25452,3601,29053
3548,48,2024-08-01,42768,2975,45743
3549,49,2024-08-01,45681,1756,47437
3550,50,2024-08-01,16444,1098,17542
3551,51,2024-08-01,44500,67,44567
3552,52,2024-08-01,36990,2704,39694
3553,53,2024-08-01,12232,3938,16170
3554,54,2024-08-01,14104,1573,15677
3555,55,2024-08-01,25354,3658,29012
3556,56,2024-08-01,20672,3066,23738
3557,57,2024-08-01,37071,1061,38132
3558,58,2024-08-01,18492,1500,19992
3559,59,2024-08-01,39549,4898,44447
3560,60,2024-08-01,39522,4635,44157
3561,61,2024-08-01,33565,522,34087
3562,62,2024-08-01,19399,1400,20799
3563,63,2024-08-01,40341,2760,43101
3564,64,2024-08-01,29848,3300,33148
3565,65,2024-08-01,0,85,85
3566,66,2024-08-01,38914,4910,43824
3567,67,2024-08-01,36008,2241,38249
3568,68,2024-08-01,15220,2762,17982
3569,69,2024-08-01,30114,4191,34305
3570,70,2024-08-01,38145,1417,39562
3571,71,2024-08-01,27842,2293,30135
3572,72,2024-08-01,41265,3516,44781
3573,73,2024-08-01,37898,1047,38945
3574,74,2024-08-01,45467,1282,46749
3575,75,2024-08-01,17459,4135,21594
3576,76,2024-08-01,14294,4545,18839
3577,77,2024-08-01,12858,4695,17553
3578,78,2024-08-01,48050,2093,50143
3579,79,2024-08-01,42421,4595,47016
3580,80,2024-08-01,25116,4872,29988
3581,81,2024-08-01,19068,1399,20467
3582,82,2024-08-01,13817,4290,18107
3583,83,2024-08-01,12662,1286,13948
3584,84,2024-08-01,41795,1603,43398
3585,85,2024-08-01,24290,2437,26727
3586,86,2024-08-01,46749,1778,48527
3587,87,2024-08-01,12914,2462,15376
3588,88,2024-08-01,26754,3138,29892
3589,89,2024-08-01,15679,650,16329
3590,90,2024-08-01,18451,-2569,15882
3591,91,2024-08-01,42362,712,43074
3592,92,2024-08-01,15455,2758,18213
3593,93,2024-08-01,21246,115,21361
3594,94,2024-08-01,28325,712,29037
3595,95,2024-08-01,46050,2095,48145
3596,96,2024-08-01,22854,3186,26040
3597,97,2024-08-01,48714,3011,51725
3598,98,2024-08-01,42795,4602,47397
3599,99,2024-08-01,46588,587,47175
3600,100,2024-08-01,46979,3754,50733
3601,101,2024-08-01,29114,236,29350
3602,102,2024-08-01,10574,2225,12799
3603,103,2024-08-01,10221,1830,12051
3604,104,2024-08-01,12242,4704,16946
3605,105,2024-08-01,24452,3604,28056
3606,106,2024-08-01,26847,4088,30935
3607,107,2024-08-01,22829,1578,24407
3608,108,2024-08-01,33800,4928,38728
3609,109,2024-08-01,18909,4276,23185
3610,110,2024-08-01,22427,3381,25808
3611,111,2024-08-01,15415,3052,18467
3612,112,2024-08-01,26697,819,27516
3613,113,2024-08-01,32394,1248,33642
3614,114,2024-08-01,20369,803,21172
3615,115,2024-08-01,42807,711,43518
3616,116,2024-08-01,30362,1580,31942
3617,117,2024-08-01,48577,-4471,44106
3618,118,2024-08-01,17922,4602,22524
3619,119,2024-08-01,31004,2536,33540
3620,120,2024-08-01,15900,1270,17170
3621,121,2024-08-01,22567,2379,24946
3622,122,2024-08-01,36332,2950,39282
3623,123,2024-08-01,20343,2610,22953
3624,124,2024-08-01,30745,-2555,28190
3625,125,2024-08-01,16980,60,17040
3626,126,2024-08-01,10286,3153,13439
3627,127,2024-08-01,18576,2913,21489
3628,128,2024-08-01,49400,2610,52010
3629,129,2024-08-01,17385,2305,19690
3630,130,2024-08-01,31683,1872,33555
3631,131,2024-08-01,34582,3851,38433
3632,132,2024-08-01,40604,516,41120
3633,133,2024-08-01,44498,349,44847
3634,134,2024-08-01,30681,3684,34365
3635,135,2024-08-01,13053,889,13942
3636,136,2024-08-01,44303,665,44968
3637,137,2024-08-01,26370,1710,28080
3638,138,2024-08-01,21532,3025,24557
3639,139,2024-08-01,38985,2037,41022
3640,140,2024-08-01,20192,3345,23537
3641,141,2024-08-01,48449,497,48946
3642,142,2024-08-01,11571,2841,14412
3643,143,2024-08-01,27399,3313,30712
3644,144,2024-08-01,12410,1308,13718
3645,145,2024-08-01,44043,1252,45295
3646,146,2024-08-01,32986,3750,36736
3647,147,2024-08-01,30192,3578,33770
3648,148,2024-08-01,13823,847,14670
3649,149,2024-08-01,38713,4123,42836
3650,150,2024-08-01,15442,118,15560
3651,151,2024-08-01,22841,4025,26866
3652,152,2024-08-01,33333,242,33575
3653,153,2024-08-01,27260,3570,30830
3654,154,2024-08-01,30274,2961,33235
3655,155,2024-08-01,46980,4433,51413
3656,156,2024-08-01,22640,1618,24258
3657,157,2024-08-01,45396,4333,49729
3658,158,2024-08-01,28173,4369,32542
3659,159,2024-08-01,33932,1901,35833
3660,160,2024-08-01,24335,2460,26795
3661,161,2024-08-01,30583,2909,33492
3662,162,2024-08-01,33735,-1749,31986
3663,163,2024-08-01,48822,4098,52920
3664,164,2024-08-01,19283,621,19904
3665,165,2024-08-01,25433,1328,26761
3666,166,2024-08-01,12162,2996,15158
3667,167,2024-08-01,21603,1107,22710
3668,168,2024-08-01,24275,4040,28315
3669,169,2024-08-01,22886,-2720,20166
3670,170,2024-08-01,39450,2043,41493
3671,171,2024-08-01,23661,146,23807
3672,172,2024-08-01,39061,3595,42656
3673,173,2024-08-01,30616,3055,33671
3674,174,2024-08-01,29028,3734,32762
3675,175,2024-08-01,13984,3642,17626
3676,176,2024-08-01,47705,3525,51230
3677,177,2024-08-01,33501,1485,34986
3678,178,2024-08-01,36281,2891,39172
3679,179,2024-08-01,44677,4910,49587
3680,180,2024-08-01,0,2673,2673
3681,181,2024-08-01,38941,3141,42082
3682,182,2024-08-01,38868,123,38991
3683,183,2024-08-01,26816,209,27025
3684,184,2024-08-01,23189,3322,26511
3685,185,2024-08-01,14249,18,14267
3686,186,2024-08-01,0,3137,3137
3687,187,2024-08-01,47863,458,48321
3688,188,2024-08-01,39475,4519,43994
3689,189,2024-08-01,10553,-2495,8058
3690,190,2024-08-01,31673,730,32403
3691,191,2024-08-01,19893,15,19908
3692,192,2024-08-01,46830,1237,48067
3693,193,2024-08-01,30878,4212,35090
3694,194,2024-08-01,13093,3585,16678
3695,195,2024-08-01,18468,1727,20195
3696,196,2024-08-01,25763,1996,27759
3697,197,2024-08-01,28674,4141,32815
3698,198,2024-08-01,0,2309,2309
3699,199,2024-08-01,22837,1083,23920
3700,200,2024-08-01,32493,4350,36843
3701,201,2024-08-01,35055,4944,39999
3702,202,2024-08-01,38936,2853,41789
3703,203,2024-08-01,16375,1446,17821
3704,204,2024-08-01,10700,1849,12549
3705,205,2024-08-01,14380,4468,18848
3706,206,2024-08-01,30279,4578,34857
3707,207,2024-08-01,37485,1820,39305
3708,208,2024-08-01,48523,4538,53061
3709,209,2024-08-01,43597,331,43928
3710,210,2024-08-01,20225,4612,24837
3711,211,2024-08-01,41260,2684,43944
3712,212,2024-08-01,19231,3871,23102
3713,213,2024-08-01,49257,1484,50741
3714,214,2024-08-01,31261,4371,35632
3715,215,2024-08-01,30660,2323,32983
3716,216,2024-08-01,29790,129,29919
3717,217,2024-08-01,25681,407,26088
3718,218,2024-08-01,37983,3721,41704
3719,219,2024-08-01,47375,1173,48548
3720,220,2024-08-01,24588,2732,27320
3721,221,2024-08-01,37787,2724,40511
3722,222,2024-08-01,40026,1994,42020
3723,223,2024-08-01,32571,2316,34887
3724,224,2024-08-01,34849,4231,39080
3725,225,2024-08-01,16622,3498,20120
3726,226,2024-08-01,25533,48,25581
3727,227,2024-08-01,37402,315,37717
3728,228,2024-08-01,11839,2065,13904
3729,229,2024-08-01,46686,649,47335
3730,230,2024-08-01,38260,3448,41708
3731,231,2024-08-01,44678,4714,49392
3732,232,2024-08-01,24377,1366,25743
3733,233,2024-08-01,13614,4418,18032
3734,234,2024-08-01,36707,3125,39832
3735,235,2024-08-01,30867,2638,33505
3736,236,2024-08-01,0,1697,1697
3737,237,2024-08-01,29573,2059,31632
3738,238,2024-08-01,18045,1797,19842
3739,239,2024-08-01,43330,4254,47584
3740,240,2024-08-01,13811,1622,15433
3741,241,2024-08-01,18321,1992,20313
3742,242,2024-08-01,13366,4552,17918
3743,243,2024-08-01,14970,4443,19413
3744,244,2024-08-01,44085,4363,48448
3745,245,2024-08-01,34016,4071,38087
3746,246,2024-08-01,13968,2571,16539
3747,247,2024-08-01,47929,2661,50590
3748,248,2024-08-01,33072,832,33904
3749,249,2024-08-01,42204,1416,43620
3750,250,2024-08-01,13474,1014,14488
3751,251,2024-08-01,29511,4272,33783
3752,252,2024-08-01,21635,506,22141
3753,253,2024-08-01,37256,4730,41986
3754,254,2024-08-01,25415,880,26295
3755,255,2024-08-01,37006,3626,40632
3756,256,2024-08-01,20294,174,20468
3757,257,2024-08-01,14767,4846,19613
3758,258,2024-08-01,20472,156,20628
3759,259,2024-08-01,35885,2578,38463
3760,260,2024-08-01,40627,2452,43079
3761,261,2024-08-01,34760,2313,37073
3762,262,2024-08-01,15598,2030,17628
3763,263,2024-08-01,13606,1563,15169
3764,264,2024-08-01,12402,3974,16376
3765,265,2024-08-01,19149,4134,23283
3766,266,2024-08-01,28529,-4231,24298
3767,267,2024-08-01,18132,632,18764
3768,268,2024-08-01,32973,2838,35811
3769,269,2024-08-01,40109,1466,41575
3770,270,2024-08-01,28046,4666,32712
3771,271,2024-08-01,33731,4716,38447
3772,272,2024-08-01,19249,1444,20693
3773,273,2024-08-01,26157,1808,27965
3774,274,2024-08-01,24869,3456,28325
3775,275,2024-08-01,28661,4684,33345
3776,276,2024-08-01,18655,3834,22489
3777,277,2024-08-01,18676,2859,21535
3778,278,2024-08-01,15115,3566,18681
3779,279,2024-08-01,46561,905,47466
3780,280,2024-08-01,11775,1652,13427
3781,281,2024-08-01,32374,-1651,30723
3782,282,2024-08-01,14778,3844,18622
3783,283,2024-08-01,25934,1116,27050
3784,284,2024-08-01,19548,3597,23145
3785,285,2024-08-01,44132,4736,48868
3786,286,2024-08-01,42084,731,42815
3787,287,2024-08-01,29014,4870,33884
3788,288,2024-08-01,16143,1977,18120
3789,289,2024-08-01,42773,3468,46241
3790,290,2024-08-01,19952,4970,24922
3791,291,2024-08-01,32622,178,32800
3792,292,2024-08-01,15063,4525,19588
3793,293,2024-08-01,14122,1805,15927
3794,294,2024-08-01,42423,1266,43689
3795,295,2024-08-01,44298,1156,45454
3796,296,2024-08-01,24838,2798,27636
3797,297,2024-08-01,25002,4650,29652
3798,298,2024-08-01,43926,3058,46984
3799,299,2024-08-01,0,972,972
3800,300,2024-08-01,35295,1480,36775
3801,301,2024-08-01,48331,-784,47547
3802,302,2024-08-01,18237,3631,21868
3803,303,2024-08-01,45988,3367,49355
3804,304,2024-08-01,49692,152,49844
3805,305,2024-08-01,49309,4634,53943
3806,306,2024-08-01,42892,3665,46557
3807,307,2024-08-01,45326,4656,49982
3808,308,2024-08-01,35006,1604,36610
3809,309,2024-08-01,38806,3570,42376
3810,310,2024-08-01,45177,3951,49128
3811,311,2024-08-01,41515,399,41914
3812,312,2024-08-01,38147,1956,40103
3813,313,2024-08-01,0,4829,4829
3814,314,2024-08-01,20790,2177,22967
3815,315,2024-08-01,18666,429,19095
3816,316,2024-08-01,25393,4716,30109
3817,317,2024-08-01,42127,2603,44730
3818,318,2024-08-01,0,1983,1983
3819,319,2024-08-01,42240,3326,45566
3820,320,2024-08-01,32929,-1632,31297
3821,321,2024-08-01,35083,336,35419
3822,322,2024-08-01,25272,3292,28564
3823,323,2024-08-01,45043,2108,47151
3824,324,2024-08-01,29769,2030,31799
3825,325,2024-08-01,38845,3139,41984
3826,326,2024-08-01,31594,2636,34230
3827,327,2024-08-01,39124,1145,40269
3828,328,2024-08-01,33594,542,34136
3829,329,2024-08-01,20643,4112,24755
3830,330,2024-08-01,46413,1508,47921
3831,331,2024-08-01,15440,2512,17952
3832,332,2024-08-01,36718,816,37534
3833,333,2024-08-01,17567,4089,21656
3834,334,2024-08-01,17311,1742,19053
3835,335,2024-08-01,21364,1466,22830
3836,336,2024-08-01,38134,874,39008
3837,337,2024-08-01,19210,3403,22613
3838,338,2024-08-01,22229,2962,25191
3839,339,2024-08-01,37457,3018,40475
3840,340,2024-08-01,24625,3724,28349
3841,341,2024-08-01,28913,4524,33437
3842,342,2024-08-01,39212,584,39796
3843,343,2024-08-01,20716,394,21110
3844,344,2024-08-01,16506,1029,17535
3845,345,2024-08-01,23517,4180,27697
3846,346,2024-08-01,38268,3938,42206
3847,347,2024-08-01,41947,2699,44646
3848,348,2024-08-01,38880,-618,38262
3849,349,2024-08-01,30867,4894,35761
3850,350,2024-08-01,12517,3595,16112
3851,351,2024-08-01,39214,1244,40458
3852,352,2024-08-01,28883,1337,30220
3853,353,2024-08-01,12855,439,13294
3854,354,2024-08-01,42316,648,42964
3855,355,2024-08-01,10328,2808,13136
3856,356,2024-08-01,46117,1744,47861
3857,357,2024-08-01,23831,3473,27304
3858,358,2024-08-01,40022,3288,43310
3859,359,2024-08-01,17834,4618,22452
3860,360,2024-08-01,38612,1668,40280
3861,361,2024-08-01,49094,2944,52038
3862,362,2024-08-01,47424,2630,50054
3863,363,2024-08-01,31907,3230,35137
3864,364,2024-08-01,38855,4013,42868
3865,365,2024-08-01,41800,3516,45316
3866,366,2024-08-01,31287,89,31376
3867,367,2024-08-01,45358,4808,50166
3868,368,2024-08-01,41931,4052,45983
3869,369,2024-08-01,21835,4190,26025
3870,370,2024-08-01,23008,652,23660
3871,371,2024-08-01,30839,2308,33147
3872,372,2024-08-01,12704,2142,14846
3873,373,2024-08-01,23328,1174,24502
3874,374,2024-08-01,46464,1319,47783
3875,375,2024-08-01,15668,4317,19985
3876,376,2024-08-01,17914,4753,22667
3877,377,2024-08-01,18291,2526,20817
3878,378,2024-08-01,36386,2760,39146
3879,379,2024-08-01,20128,4354,24482
3880,380,2024-08-01,41384,787,42171
3881,381,2024-08-01,40045,4653,44698
3882,382,2024-08-01,0,2423,2423
3883,383,2024-08-01,47235,1995,49230
3884,384,2024-08-01,42894,1880,44774
3885,385,2024-08-01,15283,368,15651
3886,386,2024-08-01,28341,3887,32228
3887,387,2024-08-01,26457,1294,27751
3888,388,2024-08-01,34779,1954,36733
3889,389,2024-08-01,10786,298,11084
3890,390,2024-08-01,20757,3280,24037
3891,391,2024-08-01,0,1401,1401
3892,392,2024-08-01,19166,3632,22798
3893,393,2024-08-01,47081,1722,48803
3894,394,2024-08-01,40037,3617,43654
3895,395,2024-08-01,37503,2477,39980
3896,396,2024-08-01,14866,3717,18583
3897,397,2024-08-01,43692,-3314,40378
3898,398,2024-08-01,30129,3062,33191
3899,399,2024-08-01,13534,4442,17976
3900,400,2024-08-01,35818,3811,39629
3901,401,2024-08-01,36455,2129,38584
3902,402,2024-08-01,16442,2404,18846
3903,403,2024-08-01,15162,1148,16310
3904,404,2024-08-01,18115,3509,21624
3905,405,2024-08-01,28473,322,28795
3906,406,2024-08-01,30383,4642,35025
3907,407,2024-08-01,18556,4501,23057
3908,408,2024-08-01,40361,1716,42077
3909,409,2024-08-01,23450,-1283,22167
3910,410,2024-08-01,28817,2385,31202
3911,411,2024-08-01,10966,1892,12858
3912,412,2024-08-01,16328,3427,19755
3913,413,2024-08-01,22578,35,22613
3914,414,2024-08-01,22469,4034,26503
3915,415,2024-08-01,16177,1884,18061
3916,416,2024-08-01,17515,4417,21932
3917,417,2024-08-01,13475,4901,18376
3918,418,2024-08-01,22968,2703,25671
3919,419,2024-08-01,22210,2156,24366
3920,420,2024-08-01,38206,2096,40302
3921,421,2024-08-01,27907,2499,30406
3922,422,2024-08-01,15851,2307,18158
3923,423,2024-08-01,33200,2498,35698
3924,424,2024-08-01,30783,3309,34092
3925,425,2024-08-01,36439,3498,39937
3926,426,2024-08-01,10446,-2161,8285
3927,427,2024-08-01,24321,3074,27395
3928,428,2024-08-01,33624,269,33893
3929,429,2024-08-01,14974,1656,16630
3930,430,2024-08-01,44449,3232,47681
3931,431,2024-08-01,13355,756,14111
3932,432,2024-08-01,22876,3064,25940
3933,433,2024-08-01,15138,1077,16215
3934,434,2024-08-01,41241,4294,45535
3935,435,2024-08-01,22880,-635,22245
3936,436,2024-08-01,21201,1859,23060
3937,437,2024-08-01,37979,-520,37459
3938,438,2024-08-01,44792,177,44969
3939,439,2024-08-01,26731,1558,28289
3940,440,2024-08-01,20751,2486,23237
3941,441,2024-08-01,43906,470,44376
3942,442,2024-08-01,44883,3341,48224
3943,443,2024-08-01,21708,3784,25492
3944,444,2024-08-01,14862,1005,15867
3945,445,2024-08-01,46520,1247,47767
3946,446,2024-08-01,26456,4105,30561
3947,447,2024-08-01,31239,4241,35480
3948,448,2024-08-01,34136,1703,35839
3949,449,2024-08-01,13147,4702,17849
3950,450,2024-08-01,20993,3101,24094
3951,451,2024-08-01,39069,2462,41531
3952,452,2024-08-01,28121,4093,32214
3953,453,2024-08-01,18824,4098,22922
3954,454,2024-08-01,35118,4539,39657
3955,455,2024-08-01,34910,2650,37560
3956,456,2024-08-01,40635,392,41027
3957,457,2024-08-01,15479,161,15640
3958,458,2024-08-01,14787,1672,16459
3959,459,2024-08-01,39727,961,40688
3960,460,2024-08-01,16578,181,16759
3961,461,2024-08-01,22753,1117,23870
3962,462,2024-08-01,23462,2613,26075
3963,463,2024-08-01,40182,720,40902
3964,464,2024-08-01,46658,3658,50316
3965,465,2024-08-01,23607,35,23642
3966,466,2024-08-01,27401,3382,30783
3967,467,2024-08-01,23010,1038,24048
3968,468,2024-08-01,18242,3528,21770
3969,469,2024-08-01,23005,4643,27648
3970,470,2024-08-01,44827,242,45069
3971,471,2024-08-01,31886,1210,33096
3972,472,2024-08-01,43858,2077,45935
3973,473,2024-08-01,34637,1379,36016
3974,474,2024-08-01,21231,4464,25695
3975,475,2024-08-01,34839,787,35626
3976,476,2024-08-01,20247,1730,21977
3977,477,2024-08-01,19399,498,19897
3978,478,2024-08-01,16598,3175,19773
3979,479,2024-08-01,47802,396,48198
3980,480,2024-08-01,21545,3271,24816
3981,481,2024-08-01,35162,2026,37188
3982,482,2024-08-01,34986,4760,39746
3983,483,2024-08-01,33639,93,33732
3984,484,2024-08-01,44196,672,44868
3985,485,2024-08-01,34602,4128,38730
3986,486,2024-08-01,15681,3586,19267
3987,487,2024-08-01,37211,4222,41433
3988,488,2024-08-01,32119,4471,36590
3989,489,2024-08-01,45401,1404,46805
3990,490,2024-08-01,19333,1456,20789
3991,491,2024-08-01,22394,2838,25232
3992,492,2024-08-01,17020,4477,21497
3993,493,2024-08-01,43985,4121,48106
3994,494,2024-08-01,27615,2421,30036
3995,495,2024-08-01,38216,1019,39235
3996,496,2024-08-01,18432,1995,20427
3997,497,2024-08-01,40535,3112,43647
3998,498,2024-08-01,40008,1016,41024
3999,499,2024-08-01,31703,2345,34048
4000,500,2024-08-01,44115,4219,48334
4001,1,2024-09-01,42863,3740,46603
4002,2,2024-09-01,47041,-1724,45317
4003,3,2024-09-01,28966,2994,31960
4004,4,2024-09-01,42248,4228,46476
4005,5,2024-09-01,26934,2865,29799
4006,6,2024-09-01,38762,1602,40364
4007,7,2024-09-01,20737,868,21605
4008,8,2024-09-01,32651,4394,37045
4009,9,2024-09-01,17992,4122,22114
4010,10,2024-09-01,20629,574,21203
4011,11,2024-09-01,22911,847,23758
4012,12,2024-09-01,22692,1665,24357
4013,13,2024-09-01,25119,1441,26560
4014,14,2024-09-01,42112,4639,46751
4015,15,2024-09-01,47766,4515,52281
4016,16,2024-09-01,25659,3514,29173
4017,17,2024-09-01,26127,2168,28295
4018,18,2024-09-01,31014,4550,35564
4019,19,2024-09-01,19389,959,20348
4020,20,2024-09-01,12950,1230,14180
4021,21,2024-09-01,49468,1049,50517
4022,22,2024-09-01,28413,560,28973
4023,23,2024-09-01,29629,264,29893
4024,24,2024-09-01,48090,2920,51010
4025,25,2024-09-01,47778,4523,52301
4026,26,2024-09-01,19503,2930,22433
4027,27,2024-09-01,44280,3392,47672
4028,28,2024-09-01,41001,2302,43303
4029,29,2024-09-01,48753,-356,48397
4030,30,2024-09-01,14675,657,15332
4031,31,2024-09-01,17406,4465,21871
4032,32,2024-09-01,44875,99,44974
4033,33,2024-09-01,31126,473,31599
4034,34,2024-09-01,39394,4648,44042
4035,35,2024-09-01,30257,1982,32239
4036,36,2024-09-01,47313,3572,50885
4037,37,2024-09-01,33771,253,34024
4038,38,2024-09-01,28032,3902,31934
4039,39,2024-09-01,31628,2514,34142
4040,40,2024-09-01,47567,444,48011
4041,41,2024-09-01,43971,3718,47689
4042,42,2024-09-01,13079,-4519,8560
4043,43,2024-09-01,34063,4324,38387
4044,44,2024-09-01,36693,1729,38422
4045,45,2024-09-01,41753,1998,43751
4046,46,2024-09-01,33256,2822,36078
4047,47,2024-09-01,38012,886,38898
4048,48,2024-09-01,38080,1449,39529
4049,49,2024-09-01,0,2429,2429
4050,50,2024-09-01,19472,4688,24160
4051,51,2024-09-01,36935,1935,38870
4052,52,2024-09-01,35904,837,36741
4053,53,2024-09-01,34325,1782,36107
4054,54,2024-09-01,10483,903,11386
4055,55,2024-09-01,43109,2263,45372
4056,56,2024-09-01,17277,2561,19838
4057,57,2024-09-01,29510,630,30140
4058,58,2024-09-01,31615,3911,35526
4059,59,2024-09-01,20685,1417,22102
4060,60,2024-09-01,26029,337,26366
4061,61,2024-09-01,39402,1617,41019
4062,62,2024-09-01,14143,1551,15694
4063,63,2024-09-01,17007,3620,20627
4064,64,2024-09-01,23848,1773,25621
4065,65,2024-09-01,42079,4784,46863
4066,66,2024-09-01,18392,1684,20076
4067,67,2024-09-01,47736,4413,52149
4068,68,2024-09-01,25544,1822,27366
4069,69,2024-09-01,16378,2562,18940
4070,70,2024-09-01,20614,758,21372
4071,71,2024-09-01,49172,3734,52906
4072,72,2024-09-01,26962,2454,29416
4073,73,2024-09-01,18169,2745,20914
4074,74,2024-09-01,44845,3611,48456
4075,75,2024-09-01,16001,4406,20407
4076,76,2024-09-01,49284,409,49693
4077,77,2024-09-01,36519,2604,39123
4078,78,2024-09-01,28894,4241,33135
4079,79,2024-09-01,10599,1010,11609
4080,80,2024-09-01,39359,2772,42131
4081,81,2024-09-01,42325,4351,46676
4082,82,2024-09-01,28322,2233,30555
4083,83,2024-09-01,46544,3834,50378
4084,84,2024-09-01,15132,520,15652
4085,85,2024-09-01,44376,2909,47285
4086,86,2024-09-01,39846,2481,42327
4087,87,2024-09-01,38184,4591,42775
4088,88,2024-09-01,38590,1656,40246
4089,89,2024-09-01,16012,492,16504
4090,90,2024-09-01,33107,3908,37015
4091,91,2024-09-01,22161,222,22383
4092,92,2024-09-01,10089,3254,13343
4093,93,2024-09-01,36260,-3753,32507
4094,94,2024-09-01,44572,3782,48354
4095,95,2024-09-01,30168,3707,33875
4096,96,2024-09-01,35062,4870,39932
4097,97,2024-09-01,37927,2915,40842
4098,98,2024-09-01,22911,1042,23953
4099,99,2024-09-01,37356,3787,41143
4100,100,2024-09-01,46959,2580,49539
4101,101,2024-09-01,31145,3443,34588
4102,102,2024-09-01,18460,1800,20260
4103,103,2024-09-01,44864,1073,45937
4104,104,2024-09-01,46654,4986,51640
4105,105,2024-09-01,34386,1150,35536
4106,106,2024-09-01,40214,3150,43364
4107,107,2024-09-01,11368,1099,12467
4108,108,2024-09-01,39510,2188,41698
4109,109,2024-09-01,44974,4043,49017
4110,110,2024-09-01,15451,466,15917
4111,111,2024-09-01,47198,2060,49258
4112,112,2024-09-01,35455,3792,39247
4113,113,2024-09-01,20008,2307,22315
4114,114,2024-09-01,46206,808,47014
4115,115,2024-09-01,40277,4433,44710
4116,116,2024-09-01,17823,1721,19544
4117,117,2024-09-01,15421,4705,20126
4118,118,2024-09-01,20683,1522,22205
4119,119,2024-09-01,42923,980,43903
4120,120,2024-09-01,13552,4399,17951
4121,121,2024-09-01,36301,3219,39520
4122,122,2024-09-01,29039,-3217,25822
4123,123,2024-09-01,47550,1491,49041
4124,124,2024-09-01,32618,74,32692
4125,125,2024-09-01,12110,4734,16844
4126,126,2024-09-01,25806,3772,29578
4127,127,2024-09-01,47761,3193,50954
4128,128,2024-09-01,11930,295,12225
4129,129,2024-09-01,46606,3398,50004
4130,130,2024-09-01,0,590,590
4131,131,2024-09-01,30947,1471,32418
4132,132,2024-09-01,13640,3573,17213
4133,133,2024-09-01,31886,3269,35155
4134,134,2024-09-01,10009,3813,13822
4135,135,2024-09-01,33262,3270,36532
4136,136,2024-09-01,29962,1794,31756
4137,137,2024-09-01,10764,1585,12349
4138,138,2024-09-01,33864,4582,38446
4139,139,2024-09-01,33098,4016,37114
4140,140,2024-09-01,31865,3240,35105
4141,141,2024-09-01,24876,1544,26420
4142,142,2024-09-01,0,1692,1692
4143,143,2024-09-01,41628,2000,43628
4144,144,2024-09-01,35629,1891,37520
4145,145,2024-09-01,42353,3511,45864
4146,146,2024-09-01,49501,3012,52513
4147,147,2024-09-01,35656,1499,37155
4148,148,2024-09-01,27749,2773,30522
4149,149,2024-09-01,35181,3552,38733
4150,150,2024-09-01,38550,1483,40033
4151,151,2024-09-01,32776,4808,37584
4152,152,2024-09-01,16605,4184,20789
4153,153,2024-09-01,10653,2762,13415
4154,154,2024-09-01,44545,4117,48662
4155,155,2024-09-01,15207,4508,19715
4156,156,2024-09-01,44435,3607,48042
4157,157,2024-09-01,32341,-3254,29087
4158,158,2024-09-01,18738,3843,22581
4159,159,2024-09-01,49636,2681,52317
4160,160,2024-09-01,12680,4806,17486
4161,161,2024-09-01,36052,4820,40872
4162,162,2024-09-01,47262,377,47639
4163,163,2024-09-01,23096,4937,28033
4164,164,2024-09-01,0,4622,4622
4165,165,2024-09-01,42465,697,43162
4166,166,2024-09-01,27662,586,28248
4167,167,2024-09-01,44067,1388,45455
4168,168,2024-09-01,14480,2009,16489
4169,169,2024-09-01,26242,4290,30532
4170,170,2024-09-01,14483,754,15237
4171,171,2024-09-01,44371,2215,46586
4172,172,2024-09-01,16210,-3634,12576
4173,173,2024-09-01,33292,1748,35040
4174,174,2024-09-01,13596,4341,17937
4175,175,2024-09-01,38445,1254,39699
4176,176,2024-09-01,12131,-4482,7649
4177,177,2024-09-01,11058,4051,15109
4178,178,2024-09-01,27816,3096,30912
4179,179,2024-09-01,46794,3879,50673
4180,180,2024-09-01,0,2015,2015
4181,181,2024-09-01,33560,2342,35902
4182,182,2024-09-01,16332,4220,20552
4183,183,2024-09-01,23181,4575,27756
4184,184,2024-09-01,20531,1011,21542
4185,185,2024-09-01,32409,3561,35970
4186,186,2024-09-01,43487,167,43654
4187,187,2024-09-01,45072,2142,47214
4188,188,2024-09-01,37092,1701,38793
4189,189,2024-09-01,46030,4117,50147
4190,190,2024-09-01,21640,158,21798
4191,191,2024-09-01,25983,2050,28033
4192,192,2024-09-01,16658,3667,20325
4193,193,2024-09-01,41658,760,42418
4194,194,2024-09-01,29177,120,29297
4195,195,2024-09-01,40275,4501,44776
4196,196,2024-09-01,16036,2673,18709
4197,197,2024-09-01,48198,301,48499
4198,198,2024-09-01,37743,4026,41769
4199,199,2024-09-01,25139,2298,27437
4200,200,2024-09-01,36729,3159,39888
4201,201,2024-09-01,29272,1718,30990
4202,202,2024-09-01,48365,3806,52171
4203,203,2024-09-01,35828,1696,37524
4204,204,2024-09-01,12845,2975,15820
4205,205,2024-09-01,45870,3318,49188
4206,206,2024-09-01,39336,1306,40642
4207,207,2024-09-01,37964,1298,39262
4208,208,2024-09-01,21636,-3,21633
4209,209,2024-09-01,39343,3528,42871
4210,210,2024-09-01,45730,969,46699
4211,211,2024-09-01,22849,1598,24447
4212,212,2024-09-01,39013,4295,43308
4213,213,2024-09-01,22826,4478,27304
4214,214,2024-09-01,37474,-4655,32819
4215,215,2024-09-01,32108,4335,36443
4216,216,2024-09-01,10819,2784,13603
4217,217,2024-09-01,0,4881,4881
4218,218,2024-09-01,48056,1027,49083
4219,219,2024-09-01,44574,1536,46110
4220,220,2024-09-01,23948,1705,25653
4221,221,2024-09-01,27071,1186,28257
4222,222,2024-09-01,45887,3273,49160
4223,223,2024-09-01,43556,856,44412
4224,224,2024-09-01,23541,3192,26733
4225,225,2024-09-01,40365,2711,43076
4226,226,2024-09-01,34918,1780,36698
4227,227,2024-09-01,48725,3226,51951
4228,228,2024-09-01,16369,3483,19852
4229,229,2024-09-01,17389,664,18053
4230,230,2024-09-01,35541,1362,36903
4231,231,2024-09-01,47281,992,48273
4232,232,2024-09-01,12591,574,13165
4233,233,2024-09-01,46690,2457,49147
4234,234,2024-09-01,35790,754,36544
4235,235,2024-09-01,20268,4292,24560
4236,236,2024-09-01,0,752,752
4237,237,2024-09-01,23782,1110,24892
4238,238,2024-09-01,32339,1264,33603
4239,239,2024-09-01,16627,228,16855
4240,240,2024-09-01,33230,4141,37371
4241,241,2024-09-01,29217,-3073,26144
4242,242,2024-09-01,15667,1956,17623
4243,243,2024-09-01,11582,2397,13979
4244,244,2024-09-01,18812,3870,22682
4245,245,2024-09-01,45092,4048,49140
4246,246,2024-09-01,0,1195,1195
4247,247,2024-09-01,43916,3270,47186
4248,248,2024-09-01,14078,735,14813
4249,249,2024-09-01,22093,3774,25867
4250,250,2024-09-01,12772,1693,14465
4251,251,2024-09-01,43496,965,44461
4252,252,2024-09-01,15808,2520,18328
4253,253,2024-09-01,44779,300,45079
4254,254,2024-09-01,14881,4632,19513
4255,255,2024-09-01,33598,490,34088
4256,256,2024-09-01,34979,3415,38394
4257,257,2024-09-01,49173,2284,51457
4258,258,2024-09-01,10016,3594,13610
4259,259,2024-09-01,46475,1205,47680
4260,260,2024-09-01,12827,1114,13941
4261,261,2024-09-01,26319,1842,28161
4262,262,2024-09-01,18623,4367,22990
4263,263,2024-09-01,13147,3133,16280
4264,264,2024-09-01,36901,4684,41585
4265,265,2024-09-01,34324,2973,37297
4266,266,2024-09-01,19867,4223,24090
4267,267,2024-09-01,15736,1267,17003
4268,268,2024-09-01,48310,3331,51641
4269,269,2024-09-01,22651,2490,25141
4270,270,2024-09-01,42736,534,43270
4271,271,2024-09-01,49215,477,49692
4272,272,2024-09-01,43000,1064,44064
4273,273,2024-09-01,25273,3948,29221
4274,274,2024-09-01,41179,4219,45398
4275,275,2024-09-01,23852,814,24666
4276,276,2024-09-01,27060,4570,31630
4277,277,2024-09-01,47290,2135,49425
4278,278,2024-09-01,29964,-251,29713
4279,279,2024-09-01,43359,84,43443
4280,280,2024-09-01,15795,4862,20657
4281,281,2024-09-01,17002,3891,20893
4282,282,2024-09-01,37739,2987,40726
4283,283,2024-09-01,32522,2329,34851
4284,284,2024-09-01,49137,1164,50301
4285,285,2024-09-01,16885,3500,20385
4286,286,2024-09-01,34139,4238,38377
4287,287,2024-09-01,16750,1369,18119
4288,288,2024-09-01,19752,3875,23627
4289,289,2024-09-01,37205,4625,41830
4290,290,2024-09-01,41670,969,42639
4291,291,2024-09-01,47231,4030,51261
4292,292,2024-09-01,0,430,430
4293,293,2024-09-01,49616,1375,50991
4294,294,2024-09-01,39502,3234,42736
4295,295,2024-09-01,13002,2354,15356
4296,296,2024-09-01,25071,3515,28586
4297,297,2024-09-01,40956,1769,42725
4298,298,2024-09-01,33316,4224,37540
4299,299,2024-09-01,21945,262,22207
4300,300,2024-09-01,22803,1347,24150
4301,301,2024-09-01,15912,639,16551
4302,302,2024-09-01,25841,3712,29553
4303,303,2024-09-01,22933,3851,26784
4304,304,2024-09-01,38072,2660,40732
4305,305,2024-09-01,14691,3614,18305
4306,306,2024-09-01,41226,2221,43447
4307,307,2024-09-01,23545,2794,26339
4308,308,2024-09-01,24236,3922,28158
4309,309,2024-09-01,25468,2937,28405
4310,310,2024-09-01,48121,2105,50226
4311,311,2024-09-01,0,3800,3800
4312,312,2024-09-01,36528,3298,39826
4313,313,2024-09-01,48980,1708,50688
4314,314,2024-09-01,25858,2274,28132
4315,315,2024-09-01,13458,4566,18024
4316,316,2024-09-01,14557,303,14860
4317,317,2024-09-01,23811,2441,26252
4318,318,2024-09-01,11350,3345,14695
4319,319,2024-09-01,34542,3468,38010
4320,320,2024-09-01,16508,3981,20489
4321,321,2024-09-01,40968,4176,45144
4322,322,2024-09-01,17669,1740,19409
4323,323,2024-09-01,34508,1000,35508
4324,324,2024-09-01,35675,4741,40416
4325,325,2024-09-01,20980,1598,22578
4326,326,2024-09-01,30909,796,31705
4327,327,2024-09-01,21581,3463,25044
4328,328,2024-09-01,37999,1337,39336
4329,329,2024-09-01,37496,3418,40914
4330,330,2024-09-01,20235,1569,21804
4331,331,2024-09-01,23802,1585,25387
4332,332,2024-09-01,44491,2085,46576
4333,333,2024-09-01,48934,698,49632
4334,334,2024-09-01,11043,3123,14166
4335,335,2024-09-01,34947,4153,39100
4336,336,2024-09-01,34151,434,34585
4337,337,2024-09-01,48795,3542,52337
4338,338,2024-09-01,18933,457,19390
4339,339,2024-09-01,28674,243,28917
4340,340,2024-09-01,32304,2517,34821
4341,341,2024-09-01,44990,1548,46538
4342,342,2024-09-01,10445,4211,14656
4343,343,2024-09-01,43064,478,43542
4344,344,2024-09-01,20184,4218,24402
4345,345,2024-09-01,49538,1602,51140
4346,346,2024-09-01,25380,4432,29812
4347,347,2024-09-01,26783,1046,27829
4348,348,2024-09-01,33991,3482,37473
4349,349,2024-09-01,43962,4517,48479
4350,350,2024-09-01,15763,4321,20084
4351,351,2024-09-01,15025,4475,19500
4352,352,2024-09-01,15420,3382,18802
4353,353,2024-09-01,38958,1632,40590
4354,354,2024-09-01,42911,3548,46459
4355,355,2024-09-01,38892,659,39551
4356,356,2024-09-01,17742,263,18005
4357,357,2024-09-01,22038,676,22714
4358,358,2024-09-01,43278,1945,45223
4359,359,2024-09-01,23279,2610,25889
4360,360,2024-09-01,26771,-1908,24863
4361,361,2024-09-01,35409,2177,37586
4362,362,2024-09-01,29945,3969,33914
4363,363,2024-09-01,15661,1871,17532
4364,364,2024-09-01,33441,1349,34790
4365,365,2024-09-01,47357,310,47667
4366,366,2024-09-01,39182,3228,42410
4367,367,2024-09-01,28659,2367,31026
4368,368,2024-09-01,44136,2048,46184
4369,369,2024-09-01,36016,2148,38164
4370,370,2024-09-01,32905,2200,35105
4371,371,2024-09-01,34117,3186,37303
4372,372,2024-09-01,26392,811,27203
4373,373,2024-09-01,40879,4584,45463
4374,374,2024-09-01,44617,2047,46664
4375,375,2024-09-01,10744,1686,12430
4376,376,2024-09-01,49821,4111,53932
4377,377,2024-09-01,24848,2026,26874
4378,378,2024-09-01,36382,3877,40259
4379,379,2024-09-01,32185,3476,35661
4380,380,2024-09-01,18586,3467,22053
4381,381,2024-09-01,21048,4044,25092
4382,382,2024-09-01,12785,4368,17153
4383,383,2024-09-01,10776,119,10895
4384,384,2024-09-01,31114,1869,32983
4385,385,2024-09-01,26352,1504,27856
4386,386,2024-09-01,15790,540,16330
4387,387,2024-09-01,42178,734,42912
4388,388,2024-09-01,22037,3612,25649
4389,389,2024-09-01,16184,-885,15299
4390,390,2024-09-01,29035,78,29113
4391,391,2024-09-01,22415,4724,27139
4392,392,2024-09-01,11204,4383,15587
4393,393,2024-09-01,14270,213,14483
4394,394,2024-09-01,36550,2502,39052
4395,395,2024-09-01,22894,1674,24568
4396,396,2024-09-01,33542,2325,35867
4397,397,2024-09-01,44424,1304,45728
4398,398,2024-09-01,22866,-2007,20859
4399,399,2024-09-01,21074,3934,25008
4400,400,2024-09-01,33438,4085,37523
4401,401,2024-09-01,23859,1958,25817
4402,402,2024-09-01,30933,4441,35374
4403,403,2024-09-01,38871,4016,42887
4404,404,2024-09-01,35339,4173,39512
4405,405,2024-09-01,44430,3673,48103
4406,406,2024-09-01,14190,3975,18165
4407,407,2024-09-01,17869,2673,20542
4408,408,2024-09-01,11051,1057,12108
4409,409,2024-09-01,14256,3361,17617
4410,410,2024-09-01,13727,2575,16302
4411,411,2024-09-01,0,1273,1273
4412,412,2024-09-01,43266,799,44065
4413,413,2024-09-01,24419,2545,26964
4414,414,2024-09-01,26323,4910,31233
4415,415,2024-09-01,32921,3357,36278
4416,416,2024-09-01,47270,3135,50405
4417,417,2024-09-01,14251,3410,17661
4418,418,2024-09-01,35397,1508,36905
4419,419,2024-09-01,20312,-348,19964
4420,420,2024-09-01,10160,2248,12408
4421,421,2024-09-01,28702,2634,31336
4422,422,2024-09-01,28816,1554,30370
4423,423,2024-09-01,28754,2416,31170
4424,424,2024-09-01,29682,4785,34467
4425,425,2024-09-01,28936,4535,33471
4426,426,2024-09-01,47006,3323,50329
4427,427,2024-09-01,14775,2399,17174
4428,428,2024-09-01,41865,-3179,38686
4429,429,2024-09-01,41498,1335,42833
4430,430,2024-09-01,30525,4570,35095
4431,431,2024-09-01,45692,2277,47969
4432,432,2024-09-01,43969,4177,48146
4433,433,2024-09-01,46528,1772,48300
4434,434,2024-09-01,0,4258,4258
4435,435,2024-09-01,27695,930,28625
4436,436,2024-09-01,31441,1003,32444
4437,437,2024-09-01,31898,4249,36147
4438,438,2024-09-01,46178,3213,49391
4439,439,2024-09-01,28907,1855,30762
4440,440,2024-09-01,40315,2439,42754
4441,441,2024-09-01,15242,941,16183
4442,442,2024-09-01,16242,3887,20129
4443,443,2024-09-01,0,1088,1088
4444,444,2024-09-01,32406,2104,34510
4445,445,2024-09-01,30368,2736,33104
4446,446,2024-09-01,0,3912,3912
4447,447,2024-09-01,14329,134,14463
4448,448,2024-09-01,46860,1212,48072
4449,449,2024-09-01,23450,3882,27332
4450,450,2024-09-01,28385,2032,30417
4451,451,2024-09-01,27674,2344,30018
4452,452,2024-09-01,0,3605,3605
4453,453,2024-09-01,35561,2957,38518
4454,454,2024-09-01,42622,2208,44830
4455,455,2024-09-01,16415,4828,21243
4456,456,2024-09-01,16253,1302,17555
4457,457,2024-09-01,35291,1519,36810
4458,458,2024-09-01,38303,3137,41440
4459,459,2024-09-01,43649,2919,46568
4460,460,2024-09-01,15078,514,15592
4461,461,2024-09-01,40147,1588,41735
4462,462,2024-09-01,28030,3298,31328
4463,463,2024-09-01,22166,1773,23939
4464,464,2024-09-01,49697,2954,52651
4465,465,2024-09-01,23740,2712,26452
4466,466,2024-09-01,32531,4992,37523
4467,467,2024-09-01,23732,2820,26552
4468,468,2024-09-01,39417,1885,41302
4469,469,2024-09-01,28653,2220,30873
4470,470,2024-09-01,31317,2276,33593
4471,471,2024-09-01,43107,2942,46049
4472,472,2024-09-01,33448,3763,37211
4473,473,2024-09-01,41968,1801,43769
4474,474,2024-09-01,45493,4213,49706
4475,475,2024-09-01,25199,-3173,22026
4476,476,2024-09-01,44563,4251,48814
4477,477,2024-09-01,22530,2793,25323
4478,478,2024-09-01,18004,3857,21861
4479,479,2024-09-01,17906,2001,19907
4480,480,2024-09-01,17252,2037,19289
4481,481,2024-09-01,43944,4107,48051
4482,482,2024-09-01,38341,1352,39693
4483,483,2024-09-01,30860,2221,33081
4484,484,2024-09-01,46264,4647,50911
4485,485,2024-09-01,21699,4339,26038
4486,486,2024-09-01,46552,1713,48265
4487,487,2024-09-01,41279,3151,44430
4488,488,2024-09-01,14666,4577,19243
4489,489,2024-09-01,33851,-114,33737
4490,490,2024-09-01,36404,2885,39289
4491,491,2024-09-01,29147,3633,32780
4492,492,2024-09-01,16511,3254,19765
4493,493,2024-09-01,13817,1137,14954
4494,494,2024-09-01,30805,2689,33494
4495,495,2024-09-01,26090,-1228,24862
4496,496,2024-09-01,39221,4985,44206
4497,497,2024-09-01,31027,4464,35491
4498,498,2024-09-01,20069,4039,24108
4499,499,2024-09-01,44803,4379,49182
4500,500,2024-09-01,34686,1291,35977
4501,1,2024-10-01,40169,4161,44330
4502,2,2024-10-01,25582,4647,30229
4503,3,2024-10-01,19695,4876,24571
4504,4,2024-10-01,16249,543,16792
4505,5,2024-10-01,25136,3893,29029
4506,6,2024-10-01,46847,1065,47912
4507,7,2024-10-01,11000,4743,15743
4508,8,2024-10-01,47170,1994,49164
4509,9,2024-10-01,31226,3516,34742
4510,10,2024-10-01,32430,3833,36263
4511,11,2024-10-01,48081,3847,51928
4512,12,2024-10-01,44533,1255,45788
4513,13,2024-10-01,28119,612,28731
4514,14,2024-10-01,28694,2891,31585
4515,15,2024-10-01,37375,3506,40881
4516,16,2024-10-01,10704,4553,15257
4517,17,2024-10-01,29835,3679,33514
4518,18,2024-10-01,24623,2502,27125
4519,19,2024-10-01,42493,2780,45273
4520,20,2024-10-01,29233,-2017,27216
4521,21,2024-10-01,32344,997,33341
4522,22,2024-10-01,28237,3611,31848
4523,23,2024-10-01,23975,3617,27592
4524,24,2024-10-01,42031,4853,46884
4525,25,2024-10-01,35133,500,35633
4526,26,2024-10-01,44760,3565,48325
4527,27,2024-10-01,16733,804,17537
4528,28,2024-10-01,37255,-1869,35386
4529,29,2024-10-01,12451,351,12802
4530,30,2024-10-01,33424,740,34164
4531,31,2024-10-01,39602,1875,41477
4532,32,2024-10-01,15668,4104,19772
4533,33,2024-10-01,35772,2889,38661
4534,34,2024-10-01,42356,4454,46810
4535,35,2024-10-01,30550,3450,34000
4536,36,2024-10-01,20215,3163,23378
4537,37,2024-10-01,27619,152,27771
4538,38,2024-10-01,17056,1424,18480
4539,39,2024-10-01,40439,1842,42281
4540,40,2024-10-01,49823,2498,52321
4541,41,2024-10-01,22940,295,23235
4542,42,2024-10-01,23512,1718,25230
4543,43,2024-10-01,47185,1531,48716
4544,44,2024-10-01,27386,185,27571
4545,45,2024-10-01,23906,4637,28543
4546,46,2024-10-01,35989,135,36124
4547,47,2024-10-01,21723,1942,23665
4548,48,2024-10-01,44490,2443,46933
4549,49,2024-10-01,46493,173,46666
4550,50,2024-10-01,44576,1392,45968
4551,51,2024-10-01,11076,4969,16045
4552,52,2024-10-01,44195,-3535,40660
4553,53,2024-10-01,14747,909,15656
4554,54,2024-10-01,38368,4237,42605
4555,55,2024-10-01,24793,2768,27561
4556,56,2024-10-01,14445,1308,15753
4557,57,2024-10-01,14804,2905,17709
4558,58,2024-10-01,27318,494,27812
4559,59,2024-10-01,14547,4014,18561
4560,60,2024-10-01,49646,218,49864
4561,61,2024-10-01,27041,485,27526
4562,62,2024-10-01,40406,2206,42612
4563,63,2024-10-01,32494,2444,34938
4564,64,2024-10-01,40623,4075,44698
4565,65,2024-10-01,23311,90,23401
4566,66,2024-10-01,41239,4897,46136
4567,67,2024-10-01,34742,2901,37643
4568,68,2024-10-01,11229,4711,15940
4569,69,2024-10-01,36076,3739,39815
4570,70,2024-10-01,46507,3346,49853
4571,71,2024-10-01,21798,2437,24235
4572,72,2024-10-01,21875,2454,24329
4573,73,2024-10-01,13329,2318,15647
4574,74,2024-10-01,31460,903,32363
4575,75,2024-10-01,22910,3733,26643
4576,76,2024-10-01,26422,1320,27742
4577,77,2024-10-01,36713,806,37519
4578,78,2024-10-01,19018,4552,23570
4579,79,2024-10-01,44847,2868,47715
4580,80,2024-10-01,49502,4940,54442
4581,81,2024-10-01,18016,3927,21943
4582,82,2024-10-01,25937,442,26379
4583,83,2024-10-01,13371,536,13907
4584,84,2024-10-01,30653,1977,32630
4585,85,2024-10-01,31315,723,32038
4586,86,2024-10-01,40367,3345,43712
4587,87,2024-10-01,22510,3338,25848
4588,88,2024-10-01,39052,482,39534
4589,89,2024-10-01,16565,895,17460
4590,90,2024-10-01,45132,1821,46953
4591,91,2024-10-01,29172,114,29286
4592,92,2024-10-01,16881,2478,19359
4593,93,2024-10-01,44964,1240,46204
4594,94,2024-10-01,44107,3135,47242
4595,95,2024-10-01,10867,2442,13309
4596,96,2024-10-01,22198,4863,27061
4597,97,2024-10-01,17551,1546,19097
4598,98,2024-10-01,31076,4223,35299
4599,99,2024-10-01,19455,1439,20894
4600,100,2024-10-01,16932,4572,21504
4601,101,2024-10-01,25038,206,25244
4602,102,2024-10-01,28069,407,28476
4603,103,2024-10-01,43631,1413,45044
4604,104,2024-10-01,23827,541,24368
4605,105,2024-10-01,24795,3415,28210
4606,106,2024-10-01,11032,4954,15986
4607,107,2024-10-01,39438,2804,42242
4608,108,2024-10-01,36497,-2175,34322
4609,109,2024-10-01,46297,3917,50214
4610,110,2024-10-01,44111,3904,48015
4611,111,2024-10-01,22178,55,22233
4612,112,2024-10-01,13758,777,14535
4613,113,2024-10-01,35075,1751,36826
4614,114,2024-10-01,18559,3624,22183
4615,115,2024-10-01,43563,3825,47388
4616,116,2024-10-01,42593,4327,46920
4617,117,2024-10-01,25264,3273,28537
4618,118,2024-10-01,16394,-2632,13762
4619,119,2024-10-01,17286,2347,19633
4620,120,2024-10-01,46305,2824,49129
4621,121,2024-10-01,23357,4438,27795
4622,122,2024-10-01,40606,1075,41681
4623,123,2024-10-01,11981,4655,16636
4624,124,2024-10-01,37531,1475,39006
4625,125,2024-10-01,41645,3513,45158
4626,126,2024-10-01,33586,3468,37054
4627,127,2024-10-01,39362,2215,41577
4628,128,2024-10-01,27219,3385,30604
4629,129,2024-10-01,41705,4519,46224
4630,130,2024-10-01,28548,2615,31163
4631,131,2024-10-01,12266,371,12637
4632,132,2024-10-01,32768,3279,36047
4633,133,2024-10-01,32032,3035,35067
4634,134,2024-10-01,39681,4283,43964
4635,135,2024-10-01,14199,3186,17385
4636,136,2024-10-01,49014,201,49215
4637,137,2024-10-01,15123,4335,19458
4638,138,2024-10-01,14017,3741,17758
4639,139,2024-10-01,40011,900,40911
4640,140,2024-10-01,40015,2442,42457
4641,141,2024-10-01,48060,4101,52161
4642,142,2024-10-01,14595,2390,16985
4643,143,2024-10-01,35488,4154,39642
4644,144,2024-10-01,25393,3872,29265
4645,145,2024-10-01,27764,2530,30294
4646,146,2024-10-01,43820,2922,46742
4647,147,2024-10-01,13637,521,14158
4648,148,2024-10-01,25261,3715,28976
4649,149,2024-10-01,28410,3161,31571
4650,150,2024-10-01,28936,590,29526
4651,151,2024-10-01,41988,1956,43944
4652,152,2024-10-01,32131,1719,33850
4653,153,2024-10-01,39770,2997,42767
4654,154,2024-10-01,40394,4581,44975
4655,155,2024-10-01,27159,1639,28798
4656,156,2024-10-01,23282,3955,27237
4657,157,2024-10-01,24936,3225,28161
4658,158,2024-10-01,35102,4940,40042
4659,159,2024-10-01,21445,97,21542
4660,160,2024-10-01,35380,2738,38118
4661,161,2024-10-01,34852,267,35119
4662,162,2024-10-01,36371,3588,39959
4663,163,2024-10-01,12677,2898,15575
4664,164,2024-10-01,10197,370,10567
4665,165,2024-10-01,29023,3074,32097
4666,166,2024-10-01,25365,703,26068
4667,167,2024-10-01,23878,2411,26289
4668,168,2024-10-01,31488,520,32008
4669,169,2024-10-01,22780,3234,26014
4670,170,2024-10-01,19593,851,20444
4671,171,2024-10-01,28509,4026,32535
4672,172,2024-10-01,42413,712,43125
4673,173,2024-10-01,34697,2649,37346
4674,174,2024-10-01,21383,139,21522
4675,175,2024-10-01,37194,3932,41126
4676,176,2024-10-01,44612,2851,47463
4677,177,2024-10-01,36878,-1382,35496
4678,178,2024-10-01,49965,3483,53448
4679,179,2024-10-01,28816,3552,32368
4680,180,2024-10-01,49758,3499,53257
4681,181,2024-10-01,24224,3459,27683
4682,182,2024-10-01,32844,1548,34392
4683,183,2024-10-01,27429,4123,31552
4684,184,2024-10-01,15456,1236,16692
4685,185,2024-10-01,38351,2073,40424
4686,186,2024-10-01,13330,2867,16197
4687,187,2024-10-01,48196,4994,53190
4688,188,2024-10-01,30895,2534,33429
4689,189,2024-10-01,25369,2338,27707
4690,190,2024-10-01,35794,1461,37255
4691,191,2024-10-01,26485,2927,29412
4692,192,2024-10-01,23749,3530,27279
4693,193,2024-10-01,37173,4971,42144
4694,194,2024-10-01,10562,2959,13521
4695,195,2024-10-01,16570,4438,21008
4696,196,2024-10-01,20492,4224,24716
4697,197,2024-10-01,12885,3782,16667
4698,198,2024-10-01,41472,2563,44035
4699,199,2024-10-01,48046,1912,49958
4700,200,2024-10-01,30223,3380,33603
4701,201,2024-10-01,45060,3852,48912
4702,202,2024-10-01,30968,3733,34701
4703,203,2024-10-01,23380,4944,28324
4704,204,2024-10-01,37208,1244,38452
4705,205,2024-10-01,48258,1410,49668
4706,206,2024-10-01,30421,2846,33267
4707,207,2024-10-01,27227,3306,30533
4708,208,2024-10-01,35132,1176,36308
4709,209,2024-10-01,17402,4407,21809
4710,210,2024-10-01,20898,4098,24996
4711,211,2024-10-01,10961,1889,12850
4712,212,2024-10-01,23305,1079,24384
4713,213,2024-10-01,43776,4466,48242
4714,214,2024-10-01,41576,2303,43879
4715,215,2024-10-01,34872,3498,38370
4716,216,2024-10-01,11858,1185,13043
4717,217,2024-10-01,34272,2124,36396
4718,218,2024-10-01,27078,1698,28776
4719,219,2024-10-01,13132,1288,14420
4720,220,2024-10-01,11174,4300,15474
4721,221,2024-10-01,36039,540,36579
4722,222,2024-10-01,49840,997,50837
4723,223,2024-10-01,46409,2439,48848
4724,224,2024-10-01,28011,1288,29299
4725,225,2024-10-01,26787,4683,31470
4726,226,2024-10-01,40475,272,40747
4727,227,2024-10-01,30674,2024,32698
4728,228,2024-10-01,27762,191,27953
4729,229,2024-10-01,13367,2988,16355
4730,230,2024-10-01,47572,3320,50892
4731,231,2024-10-01,48906,1530,50436
4732,232,2024-10-01,17827,1843,19670
4733,233,2024-10-01,14575,3754,18329
4734,234,2024-10-01,27498,3592,31090
4735,235,2024-10-01,31588,454,32042
4736,236,2024-10-01,10503,4526,15029
4737,237,2024-10-01,34594,2899,37493
4738,238,2024-10-01,13606,1669,15275
4739,239,2024-10-01,36703,4597,41300
4740,240,2024-10-01,27323,-2718,24605
4741,241,2024-10-01,42922,4254,47176
4742,242,2024-10-01,47805,3838,51643
4743,243,2024-10-01,48025,-3026,44999
4744,244,2024-10-01,32500,264,32764
4745,245,2024-10-01,20096,1156,21252
4746,246,2024-10-01,43805,-2406,41399
4747,247,2024-10-01,36049,1717,37766
4748,248,2024-10-01,39664,4266,43930
4749,249,2024-10-01,15919,201,16120
4750,250,2024-10-01,44691,3195,47886
4751,251,2024-10-01,31880,4902,36782
4752,252,2024-10-01,41749,1496,43245
4753,253,2024-10-01,38041,1519,39560
4754,254,2024-10-01,30100,3292,33392
4755,255,2024-10-01,22477,4224,26701
4756,256,2024-10-01,15282,2955,18237
4757,257,2024-10-01,15054,1298,16352
4758,258,2024-10-01,14170,2892,17062
4759,259,2024-10-01,46214,3935,50149
4760,260,2024-10-01,16228,4024,20252
4761,261,2024-10-01,18680,1726,20406
4762,262,2024-10-01,36492,1663,38155
4763,263,2024-10-01,41499,1218,42717
4764,264,2024-10-01,31743,1358,33101
4765,265,2024-10-01,18755,4684,23439
4766,266,2024-10-01,33736,2050,35786
4767,267,2024-10-01,15174,-249,14925
4768,268,2024-10-01,26890,1716,28606
4769,269,2024-10-01,42831,4285,47116
4770,270,2024-10-01,12312,3389,15701
4771,271,2024-10-01,49490,3913,53403
4772,272,2024-10-01,29620,2173,31793
4773,273,2024-10-01,28223,2919,31142
4774,274,2024-10-01,31881,2109,33990
4775,275,2024-10-01,49821,637,50458
4776,276,2024-10-01,26145,1680,27825
4777,277,2024-10-01,41179,1668,42847
4778,278,2024-10-01,12974,4776,17750
4779,279,2024-10-01,28213,1591,29804
4780,280,2024-10-01,11246,4181,15427
4781,281,2024-10-01,19965,1424,21389
4782,282,2024-10-01,29504,1367,30871
4783,283,2024-10-01,10433,2703,13136
4784,284,2024-10-01,33815,1002,34817
4785,285,2024-10-01,47304,553,47857
4786,286,2024-10-01,36892,1878,38770
4787,287,2024-10-01,36373,4152,40525
4788,288,2024-10-01,24717,4706,29423
4789,289,2024-10-01,14097,4864,18961
4790,290,2024-10-01,44253,1925,46178
4791,291,2024-10-01,33419,1652,35071
4792,292,2024-10-01,21075,3434,24509
4793,293,2024-10-01,31364,925,32289
4794,294,2024-10-01,38451,3585,42036
4795,295,2024-10-01,45946,1800,47746
4796,296,2024-10-01,36704,4772,41476
4797,297,2024-10-01,16452,605,17057
4798,298,2024-10-01,28566,1582,30148
4799,299,2024-10-01,37170,3382,40552
4800,300,2024-10-01,42853,1782,44635
4801,301,2024-10-01,15822,311,16133
4802,302,2024-10-01,20394,3602,23996
4803,303,2024-10-01,25287,815,26102
4804,304,2024-10-01,10498,2335,12833
4805,305,2024-10-01,48567,1405,49972
4806,306,2024-10-01,10471,1056,11527
4807,307,2024-10-01,37000,3927,40927
4808,308,2024-10-01,21348,1611,22959
4809,309,2024-10-01,32246,3622,35868
4810,310,2024-10-01,18644,4685,23329
4811,311,2024-10-01,28845,1980,30825
4812,312,2024-10-01,49372,2717,52089
4813,313,2024-10-01,25416,4638,30054
4814,314,2024-10-01,17821,1307,19128
4815,315,2024-10-01,32401,2348,34749
4816,316,2024-10-01,45568,3084,48652
4817,317,2024-10-01,23552,2696,26248
4818,318,2024-10-01,33369,1008,34377
4819,319,2024-10-01,30820,909,31729
4820,320,2024-10-01,35844,2164,38008
4821,321,2024-10-01,36146,773,36919
4822,322,2024-10-01,34139,4904,39043
4823,323,2024-10-01,27192,4733,31925
4824,324,2024-10-01,42687,4244,46931
4825,325,2024-10-01,47923,2750,50673
4826,326,2024-10-01,32541,4016,36557
4827,327,2024-10-01,17491,899,18390
4828,328,2024-10-01,46446,2582,49028
4829,329,2024-10-01,31265,2722,33987
4830,330,2024-10-01,25478,2048,27526
4831,331,2024-10-01,42850,4442,47292
4832,332,2024-10-01,40194,3517,43711
4833,333,2024-10-01,10503,2435,12938
4834,334,2024-10-01,45989,2532,48521
4835,335,2024-10-01,13254,3920,17174
4836,336,2024-10-01,31553,10,31563
4837,337,2024-10-01,23584,2324,25908
4838,338,2024-10-01,16679,3428,20107
4839,339,2024-10-01,34092,2700,36792
4840,340,2024-10-01,27396,1220,28616
4841,341,2024-10-01,34203,2371,36574
4842,342,2024-10-01,11327,4035,15362
4843,343,2024-10-01,28654,3366,32020
4844,344,2024-10-01,31109,444,31553
4845,345,2024-10-01,36944,-4193,32751
4846,346,2024-10-01,42388,4455,46843
4847,347,2024-10-01,18657,3676,22333
4848,348,2024-10-01,28582,2911,31493
4849,349,2024-10-01,30826,2909,33735
4850,350,2024-10-01,22799,2223,25022
4851,351,2024-10-01,36179,1209,37388
4852,352,2024-10-01,44276,640,44916
4853,353,2024-10-01,29611,-4674,24937
4854,354,2024-10-01,29851,2760,32611
4855,355,2024-10-01,17353,2229,19582
4856,356,2024-10-01,16305,4087,20392
4857,357,2024-10-01,20192,-3169,17023
4858,358,2024-10-01,31860,3265,35125
4859,359,2024-10-01,46442,4351,50793
4860,360,2024-10-01,40168,926,41094
4861,361,2024-10-01,33752,4919,38671
4862,362,2024-10-01,44562,4984,49546
4863,363,2024-10-01,11835,909,12744
4864,364,2024-10-01,36788,1415,38203
4865,365,2024-10-01,17618,503,18121
4866,366,2024-10-01,48868,2478,51346
4867,367,2024-10-01,16148,2317,18465
4868,368,2024-10-01,13432,1411,14843
4869,369,2024-10-01,26631,370,27001
4870,370,2024-10-01,17902,670,18572
4871,371,2024-10-01,16468,2920,19388
4872,372,2024-10-01,22002,317,22319
4873,373,2024-10-01,30101,604,30705
4874,374,2024-10-01,10802,2435,13237
4875,375,2024-10-01,22110,2413,24523
4876,376,2024-10-01,45684,1634,47318
4877,377,2024-10-01,48269,4192,52461
4878,378,2024-10-01,16040,2364,18404
4879,379,2024-10-01,14582,1490,16072
4880,380,2024-10-01,26174,4860,31034
4881,381,2024-10-01,34244,1705,35949
4882,382,2024-10-01,34758,-2644,32114
4883,383,2024-10-01,37449,1218,38667
4884,384,2024-10-01,0,3213,3213
4885,385,2024-10-01,31488,3186,34674
4886,386,2024-10-01,33904,2560,36464
4887,387,2024-10-01,26180,4075,30255
4888,388,2024-10-01,26193,4540,30733
4889,389,2024-10-01,29996,238,30234
4890,390,2024-10-01,42955,-2147,40808
4891,391,2024-10-01,21996,3680,25676
4892,392,2024-10-01,27046,3933,30979
4893,393,2024-10-01,34822,2676,37498
4894,394,2024-10-01,24228,1765,25993
4895,395,2024-10-01,46716,1378,48094
4896,396,2024-10-01,43748,2413,46161
4897,397,2024-10-01,45526,1891,47417
4898,398,2024-10-01,47860,1921,49781
4899,399,2024-10-01,27514,3401,30915
4900,400,2024-10-01,42901,1770,44671
4901,401,2024-10-01,10819,2152,12971
4902,402,2024-10-01,31338,1571,32909
4903,403,2024-10-01,39251,718,39969
4904,404,2024-10-01,26220,213,26433
4905,405,2024-10-01,22296,2748,25044
4906,406,2024-10-01,28086,4892,32978
4907,407,2024-10-01,37839,403,38242
4908,408,2024-10-01,47239,4766,52005
4909,409,2024-10-01,33535,-928,32607
4910,410,2024-10-01,37307,3884,41191
4911,411,2024-10-01,0,2113,2113
4912,412,2024-10-01,12433,3781,16214
4913,413,2024-10-01,22380,4327,26707
4914,414,2024-10-01,10603,1509,12112
4915,415,2024-10-01,37212,4146,41358
4916,416,2024-10-01,30634,736,31370
4917,417,2024-10-01,0,4960,4960
4918,418,2024-10-01,30624,3728,34352
4919,419,2024-10-01,49598,3516,53114
4920,420,2024-10-01,45927,-4781,41146
4921,421,2024-10-01,24143,413,24556
4922,422,2024-10-01,49792,3444,53236
4923,423,2024-10-01,14803,38,14841
4924,424,2024-10-01,46296,1338,47634
4925,425,2024-10-01,33303,372,33675
4926,426,2024-10-01,15777,1479,17256
4927,427,2024-10-01,11583,2085,13668
4928,428,2024-10-01,45023,4294,49317
4929,429,2024-10-01,14691,1706,16397
4930,430,2024-10-01,48047,3748,51795
4931,431,2024-10-01,45447,263,45710
4932,432,2024-10-01,42050,4576,46626
4933,433,2024-10-01,16914,2619,19533
4934,434,2024-10-01,13773,138,13911
4935,435,2024-10-01,11050,3352,14402
4936,436,2024-10-01,19576,1492,21068
4937,437,2024-10-01,18344,-974,17370
4938,438,2024-10-01,49954,179,50133
4939,439,2024-10-01,27995,4366,32361
4940,440,2024-10-01,39553,4902,44455
4941,441,2024-10-01,19097,158,19255
4942,442,2024-10-01,12656,1713,14369
4943,443,2024-10-01,20933,4424,25357
4944,444,2024-10-01,39841,1061,40902
4945,445,2024-10-01,17133,3632,20765
4946,446,2024-10-01,45146,389,45535
4947,447,2024-10-01,25607,3386,28993
4948,448,2024-10-01,17436,919,18355
4949,449,2024-10-01,30720,4958,35678
4950,450,2024-10-01,16487,2381,18868
4951,451,2024-10-01,16786,3704,20490
4952,452,2024-10-01,33456,1370,34826
4953,453,2024-10-01,10641,1935,12576
4954,454,2024-10-01,29848,2675,32523
4955,455,2024-10-01,42414,2017,44431
4956,456,2024-10-01,47602,4759,52361
4957,457,2024-10-01,44033,841,44874
4958,458,2024-10-01,10957,3750,14707
4959,459,2024-10-01,12999,2928,15927
4960,460,2024-10-01,30625,2970,33595
4961,461,2024-10-01,32621,4542,37163
4962,462,2024-10-01,10824,75,10899
4963,463,2024-10-01,20223,3860,24083
4964,464,2024-10-01,23307,1272,24579
4965,465,2024-10-01,19521,188,19709
4966,466,2024-10-01,30300,4214,34514
4967,467,2024-10-01,23830,4138,27968
4968,468,2024-10-01,22809,2761,25570
4969,469,2024-10-01,17687,870,18557
4970,470,2024-10-01,19476,6,19482
4971,471,2024-10-01,27802,4694,32496
4972,472,2024-10-01,15505,1872,17377
4973,473,2024-10-01,21256,1860,23116
4974,474,2024-10-01,19593,565,20158
4975,475,2024-10-01,16637,-2175,14462
4976,476,2024-10-01,15238,576,15814
4977,477,2024-10-01,22749,4544,27293
4978,478,2024-10-01,19529,4051,23580
4979,479,2024-10-01,15049,1812,16861
4980,480,2024-10-01,43941,3946,47887
4981,481,2024-10-01,24148,3711,27859
4982,482,2024-10-01,26222,2342,28564
4983,483,2024-10-01,29354,2328,31682
4984,484,2024-10-01,20571,4426,24997
4985,485,2024-10-01,32923,3620,36543
4986,486,2024-10-01,29077,1665,30742
4987,487,2024-10-01,28639,4992,33631
4988,488,2024-10-01,36640,1045,37685
4989,489,2024-10-01,14937,441,15378
4990,490,2024-10-01,20881,2490,23371
4991,491,2024-10-01,41926,2638,44564
4992,492,2024-10-01,41658,3681,45339
4993,493,2024-10-01,48571,1468,50039
4994,494,2024-10-01,14133,4437,18570
4995,495,2024-10-01,31622,4012,35634
4996,496,2024-10-01,12601,1710,14311
4997,497,2024-10-01,21522,2055,23577
4998,498,2024-10-01,32549,3133,35682
4999,499,2024-10-01,0,2571,2571
5000,500,2024-10-01,33826,1935,35761
5001,1,2024-11-01,18252,983,19235
5002,2,2024-11-01,22094,1396,23490
5003,3,2024-11-01,22206,3317,25523
5004,4,2024-11-01,43289,678,43967
5005,5,2024-11-01,38724,1080,39804
5006,6,2024-11-01,45168,4963,50131
5007,7,2024-11-01,26002,3709,29711
5008,8,2024-11-01,45940,744,46684
5009,9,2024-11-01,11336,344,11680
5010,10,2024-11-01,31850,2462,34312
5011,11,2024-11-01,16249,313,16562
5012,12,2024-11-01,44790,2892,47682
5013,13,2024-11-01,23687,3993,27680
5014,14,2024-11-01,11062,2407,13469
5015,15,2024-11-01,23318,1052,24370
5016,16,2024-11-01,37604,3652,41256
5017,17,2024-11-01,30079,357,30436
5018,18,2024-11-01,23108,2934,26042
5019,19,2024-11-01,45245,3658,48903
5020,20,2024-11-01,21799,-585,21214
5021,21,2024-11-01,19546,3358,22904
5022,22,2024-11-01,35285,561,35846
5023,23,2024-11-01,0,4453,4453
5024,24,2024-11-01,43611,1139,44750
5025,25,2024-11-01,16923,4153,21076
5026,26,2024-11-01,11607,501,12108
5027,27,2024-11-01,17022,107,17129
5028,28,2024-11-01,46917,1504,48421
5029,29,2024-11-01,0,3439,3439
5030,30,2024-11-01,14985,1176,16161
5031,31,2024-11-01,34487,2374,36861
5032,32,2024-11-01,49597,3083,52680
5033,33,2024-11-01,45921,4604,50525
5034,34,2024-11-01,38402,4407,42809
5035,35,2024-11-01,34170,4397,38567
5036,36,2024-11-01,35252,932,36184
5037,37,2024-11-01,11823,2283,14106
5038,38,2024-11-01,29151,4868,34019
5039,39,2024-11-01,46283,4498,50781
5040,40,2024-11-01,34281,3664,37945
5041,41,2024-11-01,45330,3481,48811
5042,42,2024-11-01,12601,2393,14994
5043,43,2024-11-01,39089,4820,43909
5044,44,2024-11-01,35635,-2733,32902
5045,45,2024-11-01,41898,1862,43760
5046,46,2024-11-01,39173,1994,41167
5047,47,2024-11-01,27552,2522,30074
5048,48,2024-11-01,42683,1872,44555
5049,49,2024-11-01,19299,4526,23825
5050,50,2024-11-01,15385,-4562,10823
5051,51,2024-11-01,40774,2924,43698
5052,52,2024-11-01,48153,965,49118
5053,53,2024-11-01,29469,2794,32263
5054,54,2024-11-01,46217,4393,50610
5055,55,2024-11-01,21507,4296,25803
5056,56,2024-11-01,16750,1948,18698
5057,57,2024-11-01,10169,4560,14729
5058,58,2024-11-01,21472,2061,23533
5059,59,2024-11-01,46903,914,47817
5060,60,2024-11-01,14652,1759,16411
5061,61,2024-11-01,26083,2075,28158
5062,62,2024-11-01,43443,2856,46299
5063,63,2024-11-01,39861,2497,42358
5064,64,2024-11-01,40488,1546,42034
5065,65,2024-11-01,29087,4304,33391
5066,66,2024-11-01,48774,3747,52521
5067,67,2024-11-01,45648,4293,49941
5068,68,2024-11-01,38091,691,38782
5069,69,2024-11-01,45567,3752,49319
5070,70,2024-11-01,26812,4116,30928
5071,71,2024-11-01,32012,3146,35158
5072,72,2024-11-01,18019,714,18733
5073,73,2024-11-01,46689,2275,48964
5074,74,2024-11-01,27079,1259,28338
5075,75,2024-11-01,26559,2319,28878
5076,76,2024-11-01,23012,3492,26504
5077,77,2024-11-01,48478,529,49007
5078,78,2024-11-01,49016,3178,52194
5079,79,2024-11-01,16860,1512,18372
5080,80,2024-11-01,21968,1274,23242
5081,81,2024-11-01,14552,-2314,12238
5082,82,2024-11-01,49652,4081,53733
5083,83,2024-11-01,49035,4666,53701
5084,84,2024-11-01,10054,2442,12496
5085,85,2024-11-01,44910,659,45569
5086,86,2024-11-01,14586,1249,15835
5087,87,2024-11-01,34996,2700,37696
5088,88,2024-11-01,33917,4020,37937
5089,89,2024-11-01,21863,3586,25449
5090,90,2024-11-01,45990,3779,49769
5091,91,2024-11-01,26780,4286,31066
5092,92,2024-11-01,23879,4191,28070
5093,93,2024-11-01,31822,2154,33976
5094,94,2024-11-01,40795,4113,44908
5095,95,2024-11-01,47428,4617,52045
5096,96,2024-11-01,34403,1059,35462
5097,97,2024-11-01,36403,1476,37879
5098,98,2024-11-01,47242,189,47431
5099,99,2024-11-01,24623,1969,26592
5100,100,2024-11-01,17909,3720,21629
5101,101,2024-11-01,40254,2510,42764
5102,102,2024-11-01,25548,579,26127
5103,103,2024-11-01,16635,4183,20818
5104,104,2024-11-01,24986,2150,27136
5105,105,2024-11-01,17258,1187,18445
5106,106,2024-11-01,13431,753,14184
5107,107,2024-11-01,12657,4550,17207
5108,108,2024-11-01,25902,-4783,21119
5109,109,2024-11-01,48126,1841,49967
5110,110,2024-11-01,26859,1410,28269
5111,111,2024-11-01,35534,1363,36897
5112,112,2024-11-01,31972,2044,34016
5113,113,2024-11-01,28979,630,29609
5114,114,2024-11-01,38893,4205,43098
5115,115,2024-11-01,27926,602,28528
5116,116,2024-11-01,42678,1867,44545
5117,117,2024-11-01,41113,4320,45433
5118,118,2024-11-01,27051,4892,31943
5119,119,2024-11-01,29768,2238,32006
5120,120,2024-11-01,16695,4419,21114
5121,121,2024-11-01,23100,2691,25791
5122,122,2024-11-01,36941,1164,38105
5123,123,2024-11-01,21383,1235,22618
5124,124,2024-11-01,26690,1136,27826
5125,125,2024-11-01,29748,283,30031
5126,126,2024-11-01,30198,-1740,28458
5127,127,2024-11-01,27762,2015,29777
5128,128,2024-11-01,46849,3694,50543
5129,129,2024-11-01,19286,3980,23266
5130,130,2024-11-01,31458,4793,36251
5131,131,2024-11-01,25764,994,26758
5132,132,2024-11-01,32695,1187,33882
5133,133,2024-11-01,26744,3955,30699
5134,134,2024-11-01,12106,2085,14191
5135,135,2024-11-01,45709,345,46054
5136,136,2024-11-01,29291,575,29866
5137,137,2024-11-01,28102,95,28197
5138,138,2024-11-01,26559,4982,31541
5139,139,2024-11-01,21375,408,21783
5140,140,2024-11-01,20990,4890,25880
5141,141,2024-11-01,42888,4370,47258
5142,142,2024-11-01,48202,1089,49291
5143,143,2024-11-01,44670,1501,46171
5144,144,2024-11-01,48697,3637,52334
5145,145,2024-11-01,46682,4335,51017
5146,146,2024-11-01,13901,2898,16799
5147,147,2024-11-01,49932,494,50426
5148,148,2024-11-01,17125,2123,19248
5149,149,2024-11-01,42794,-288,42506
5150,150,2024-11-01,43823,2510,46333
5151,151,2024-11-01,31590,3128,34718
5152,152,2024-11-01,31331,1477,32808
5153,153,2024-11-01,35971,1429,37400
5154,154,2024-11-01,19520,331,19851
5155,155,2024-11-01,21793,3526,25319
5156,156,2024-11-01,48348,1638,49986
5157,157,2024-11-01,30094,542,30636
5158,158,2024-11-01,19776,2286,22062
5159,159,2024-11-01,37689,3381,41070
5160,160,2024-11-01,16063,624,16687
5161,161,2024-11-01,26335,2220,28555
5162,162,2024-11-01,36380,1289,37669
5163,163,2024-11-01,40013,1446,41459
5164,164,2024-11-01,22749,4120,26869
5165,165,2024-11-01,42441,597,43038
5166,166,2024-11-01,26808,3607,30415
5167,167,2024-11-01,48819,4402,53221
5168,168,2024-11-01,21590,3566,25156
5169,169,2024-11-01,19142,4409,23551
5170,170,2024-11-01,36761,3398,40159
5171,171,2024-11-01,38756,3799,42555
5172,172,2024-11-01,19694,4041,23735
5173,173,2024-11-01,45618,4927,50545
5174,174,2024-11-01,26815,2610,29425
5175,175,2024-11-01,21087,336,21423
5176,176,2024-11-01,45339,3852,49191
5177,177,2024-11-01,19004,1590,20594
5178,178,2024-11-01,18745,85,18830
5179,179,2024-11-01,29712,3345,33057
5180,180,2024-11-01,32624,2678,35302
5181,181,2024-11-01,23694,2000,25694
5182,182,2024-11-01,34793,3027,37820
5183,183,2024-11-01,22935,4372,27307
5184,184,2024-11-01,24747,2782,27529
5185,185,2024-11-01,24228,1777,26005
5186,186,2024-11-01,43779,3165,46944
5187,187,2024-11-01,45076,2032,47108
5188,188,2024-11-01,12972,870,13842
5189,189,2024-11-01,11545,2129,13674
5190,190,2024-11-01,11686,-1416,10270
5191,191,2024-11-01,48845,4337,53182
5192,192,2024-11-01,38028,2583,40611
5193,193,2024-11-01,32155,711,32866
5194,194,2024-11-01,32983,4890,37873
5195,195,2024-11-01,17006,2944,19950
5196,196,2024-11-01,16550,2314,18864
5197,197,2024-11-01,40022,4371,44393
5198,198,2024-11-01,27568,3031,30599
5199,199,2024-11-01,48323,911,49234
5200,200,2024-11-01,24679,1699,26378
5201,201,2024-11-01,43031,249,43280
5202,202,2024-11-01,10522,1621,12143
5203,203,2024-11-01,41741,3584,45325
5204,204,2024-11-01,13613,4369,17982
5205,205,2024-11-01,42680,-2121,40559
5206,206,2024-11-01,49399,4723,54122
5207,207,2024-11-01,45040,2435,47475
5208,208,2024-11-01,19111,1444,20555
5209,209,2024-11-01,27980,2928,30908
5210,210,2024-11-01,42666,1687,44353
5211,211,2024-11-01,19054,702,19756
5212,212,2024-11-01,26421,4170,30591
5213,213,2024-11-01,36593,1955,38548
5214,214,2024-11-01,19116,3430,22546
5215,215,2024-11-01,18381,4061,22442
5216,216,2024-11-01,47536,80,47616
5217,217,2024-11-01,24357,3400,27757
5218,218,2024-11-01,20006,4464,24470
5219,219,2024-11-01,25333,1282,26615
5220,220,2024-11-01,28716,3867,32583
5221,221,2024-11-01,12136,3827,15963
5222,222,2024-11-01,36479,3694,40173
5223,223,2024-11-01,34928,4618,39546
5224,224,2024-11-01,40823,3717,44540
5225,225,2024-11-01,14729,2153,16882
5226,226,2024-11-01,24418,1643,26061
5227,227,2024-11-01,39470,1670,41140
5228,228,2024-11-01,46254,21,46275
5229,229,2024-11-01,47702,2276,49978
5230,230,2024-11-01,17811,1168,18979
5231,231,2024-11-01,23126,1589,24715
5232,232,2024-11-01,11059,1572,12631
5233,233,2024-11-01,22657,852,23509
5234,234,2024-11-01,22592,1235,23827
5235,235,2024-11-01,36685,856,37541
5236,236,2024-11-01,23505,540,24045
5237,237,2024-11-01,18466,4892,23358
5238,238,2024-11-01,42860,4612,47472
5239,239,2024-11-01,45423,3786,49209
5240,240,2024-11-01,17908,4285,22193
5241,241,2024-11-01,22301,3903,26204
5242,242,2024-11-01,40945,3708,44653
5243,243,2024-11-01,23612,928,24540
5244,244,2024-11-01,45306,3216,48522
5245,245,2024-11-01,31798,4996,36794
5246,246,2024-11-01,25989,302,26291
5247,247,2024-11-01,28726,4718,33444
5248,248,2024-11-01,19891,3590,23481
5249,249,2024-11-01,42285,3085,45370
5250,250,2024-11-01,25272,-1191,24081
5251,251,2024-11-01,18587,529,19116
5252,252,2024-11-01,29955,943,30898
5253,253,2024-11-01,33223,3185,36408
5254,254,2024-11-01,35722,689,36411
5255,255,2024-11-01,10694,4894,15588
5256,256,2024-11-01,49856,246,50102
5257,257,2024-11-01,43044,3779,46823
5258,258,2024-11-01,0,2727,2727
5259,259,2024-11-01,38853,4865,43718
5260,260,2024-11-01,12678,4041,16719
5261,261,2024-11-01,22218,2690,24908
5262,262,2024-11-01,31269,1151,32420
5263,263,2024-11-01,46296,640,46936
5264,264,2024-11-01,18634,4236,22870
5265,265,2024-11-01,28913,535,29448
5266,266,2024-11-01,21132,425,21557
5267,267,2024-11-01,27791,2499,30290
5268,268,2024-11-01,12876,3336,16212
5269,269,2024-11-01,15170,2681,17851
5270,270,2024-11-01,45863,2288,48151
5271,271,2024-11-01,22974,539,23513
5272,272,2024-11-01,33265,95,33360
5273,273,2024-11-01,41881,1576,43457
5274,274,2024-11-01,38659,3259,41918
5275,275,2024-11-01,44957,3658,48615
5276,276,2024-11-01,40319,2527,42846
5277,277,2024-11-01,48122,1120,49242
5278,278,2024-11-01,43109,1535,44644
5279,279,2024-11-01,21536,231,21767
5280,280,2024-11-01,15398,390,15788
5281,281,2024-11-01,34539,3052,37591
5282,282,2024-11-01,0,2737,2737
5283,283,2024-11-01,44389,2921,47310
5284,284,2024-11-01,22360,4571,26931
5285,285,2024-11-01,23776,1846,25622
5286,286,2024-11-01,28063,951,29014
5287,287,2024-11-01,18028,3926,21954
5288,288,2024-11-01,43700,600,44300
5289,289,2024-11-01,25789,3921,29710
5290,290,2024-11-01,38163,3568,41731
5291,291,2024-11-01,15613,2898,18511
5292,292,2024-11-01,37735,1903,39638
5293,293,2024-11-01,19534,510,20044
5294,294,2024-11-01,30721,2048,32769
5295,295,2024-11-01,47306,2754,50060
5296,296,2024-11-01,19177,1646,20823
5297,297,2024-11-01,29655,3717,33372
5298,298,2024-11-01,24129,1233,25362
5299,299,2024-11-01,34588,1445,36033
5300,300,2024-11-01,25794,2480,28274
5301,301,2024-11-01,45745,3221,48966
5302,302,2024-11-01,14098,1108,15206
5303,303,2024-11-01,30882,4165,35047
5304,304,2024-11-01,31454,4071,35525
5305,305,2024-11-01,33773,4551,38324
5306,306,2024-11-01,0,2337,2337
5307,307,2024-11-01,44425,3538,47963
5308,308,2024-11-01,29169,2976,32145
5309,309,2024-11-01,49615,1087,50702
5310,310,2024-11-01,19955,3227,23182
5311,311,2024-11-01,34655,2217,36872
5312,312,2024-11-01,39207,1411,40618
5313,313,2024-11-01,47666,2780,50446
5314,314,2024-11-01,20391,3755,24146
5315,315,2024-11-01,28184,3617,31801
5316,316,2024-11-01,43135,2290,45425
5317,317,2024-11-01,21797,155,21952
5318,318,2024-11-01,37970,3054,41024
5319,319,2024-11-01,42859,265,43124
5320,320,2024-11-01,20178,3064,23242
5321,321,2024-11-01,12785,4851,17636
5322,322,2024-11-01,36261,2358,38619
5323,323,2024-11-01,33917,2906,36823
5324,324,2024-11-01,43266,4832,48098
5325,325,2024-11-01,33016,4599,37615
5326,326,2024-11-01,16222,4883,21105
5327,327,2024-11-01,38442,1673,40115
5328,328,2024-11-01,34235,-1040,33195
5329,329,2024-11-01,19864,3476,23340
5330,330,2024-11-01,25250,4812,30062
5331,331,2024-11-01,34810,2932,37742
5332,332,2024-11-01,29547,3786,33333
5333,333,2024-11-01,16856,2502,19358
5334,334,2024-11-01,35555,1891,37446
5335,335,2024-11-01,10690,1331,12021
5336,336,2024-11-01,46866,2653,49519
5337,337,2024-11-01,22646,937,23583
5338,338,2024-11-01,33497,3765,37262
5339,339,2024-11-01,40471,4566,45037
5340,340,2024-11-01,27334,3568,30902
5341,341,2024-11-01,16320,1950,18270
5342,342,2024-11-01,38770,224,38994
5343,343,2024-11-01,48214,3802,52016
5344,344,2024-11-01,41614,2960,44574
5345,345,2024-11-01,45333,1973,47306
5346,346,2024-11-01,36279,1764,38043
5347,347,2024-11-01,34533,2171,36704
5348,348,2024-11-01,24567,4714,29281
5349,349,2024-11-01,37434,3518,40952
5350,350,2024-11-01,24971,1086,26057
5351,351,2024-11-01,44391,3050,47441
5352,352,2024-11-01,41098,2156,43254
5353,353,2024-11-01,16644,4276,20920
5354,354,2024-11-01,15590,1971,17561
5355,355,2024-11-01,32339,2617,34956
5356,356,2024-11-01,27321,4759,32080
5357,357,2024-11-01,29473,439,29912
5358,358,2024-11-01,14400,3378,17778
5359,359,2024-11-01,46299,805,47104
5360,360,2024-11-01,39719,2359,42078
5361,361,2024-11-01,26329,-1934,24395
5362,362,2024-11-01,49280,755,50035
5363,363,2024-11-01,19187,2587,21774
5364,364,2024-11-01,45258,2111,47369
5365,365,2024-11-01,36000,451,36451
5366,366,2024-11-01,30642,2436,33078
5367,367,2024-11-01,30967,2021,32988
5368,368,2024-11-01,32371,1164,33535
5369,369,2024-11-01,12142,192,12334
5370,370,2024-11-01,19682,2658,22340
5371,371,2024-11-01,33816,2660,36476
5372,372,2024-11-01,20987,4952,25939
5373,373,2024-11-01,39663,3725,43388
5374,374,2024-11-01,30359,424,30783
5375,375,2024-11-01,18095,2074,20169
5376,376,2024-11-01,14104,274,14378
5377,377,2024-11-01,0,3748,3748
5378,378,2024-11-01,38827,4995,43822
5379,379,2024-11-01,39686,14,39700
5380,380,2024-11-01,38457,1881,40338
5381,381,2024-11-01,47939,2403,50342
5382,382,2024-11-01,16487,2840,19327
5383,383,2024-11-01,38388,-636,37752
5384,384,2024-11-01,30400,382,30782
5385,385,2024-11-01,13066,4058,17124
5386,386,2024-11-01,0,4243,4243
5387,387,2024-11-01,25039,1111,26150
5388,388,2024-11-01,18481,1458,19939
5389,389,2024-11-01,19804,2927,22731
5390,390,2024-11-01,49571,110,49681
5391,391,2024-11-01,32460,-3582,28878
5392,392,2024-11-01,33823,1397,35220
5393,393,2024-11-01,31009,516,31525
5394,394,2024-11-01,16952,2460,19412
5395,395,2024-11-01,22526,1679,24205
5396,396,2024-11-01,18303,2358,20661
5397,397,2024-11-01,25471,796,26267
5398,398,2024-11-01,25135,2078,27213
5399,399,2024-11-01,38991,4825,43816
5400,400,2024-11-01,36894,86,36980
5401,401,2024-11-01,32956,1529,34485
5402,402,2024-11-01,0,1552,1552
5403,403,2024-11-01,48552,77,48629
5404,404,2024-11-01,45386,2588,47974
5405,405,2024-11-01,28686,3051,31737
5406,406,2024-11-01,23297,4369,27666
5407,407,2024-11-01,41516,3132,44648
5408,408,2024-11-01,18492,2983,21475
5409,409,2024-11-01,23161,966,24127
5410,410,2024-11-01,34841,10,34851
5411,411,2024-11-01,24713,2945,27658
5412,412,2024-11-01,40875,3974,44849
5413,413,2024-11-01,26701,1244,27945
5414,414,2024-11-01,49777,2138,51915
5415,415,2024-11-01,19259,2788,22047
5416,416,2024-11-01,26427,2021,28448
5417,417,2024-11-01,13846,4715,18561
5418,418,2024-11-01,45248,-4035,41213
5419,419,2024-11-01,24209,887,25096
5420,420,2024-11-01,29255,3055,32310
5421,421,2024-11-01,18192,4361,22553
5422,422,2024-11-01,26590,3785,30375
5423,423,2024-11-01,40708,1980,42688
5424,424,2024-11-01,27482,2813,30295
5425,425,2024-11-01,47650,480,48130
5426,426,2024-11-01,22955,1777,24732
5427,427,2024-11-01,27575,3754,31329
5428,428,2024-11-01,26897,2255,29152
5429,429,2024-11-01,42307,2165,44472
5430,430,2024-11-01,22415,425,22840
5431,431,2024-11-01,40445,1237,41682
5432,432,2024-11-01,41520,1477,42997
5433,433,2024-11-01,42891,1526,44417
5434,434,2024-11-01,41297,3556,44853
5435,435,2024-11-01,31487,3900,35387
5436,436,2024-11-01,38625,3383,42008
5437,437,2024-11-01,25186,2434,27620
5438,438,2024-11-01,22612,3828,26440
5439,439,2024-11-01,38342,1763,40105
5440,440,2024-11-01,20116,930,21046
5441,441,2024-11-01,28780,1535,30315
5442,442,2024-11-01,43999,4635,48634
5443,443,2024-11-01,11462,3793,15255
5444,444,2024-11-01,48219,2667,50886
5445,445,2024-11-01,31077,3514,34591
5446,446,2024-11-01,44974,551,45525
5447,447,2024-11-01,27432,3431,30863
5448,448,2024-11-01,16032,3588,19620
5449,449,2024-11-01,25431,4297,29728
5450,450,2024-11-01,34740,2115,36855
5451,451,2024-11-01,29908,20,29928
5452,452,2024-11-01,33408,4452,37860
5453,453,2024-11-01,0,4641,4641
5454,454,2024-11-01,41785,3895,45680
5455,455,2024-11-01,41527,928,42455
5456,456,2024-11-01,22255,952,23207
5457,457,2024-11-01,49464,3386,52850
5458,458,2024-11-01,42296,2243,44539
5459,459,2024-11-01,0,652,652
5460,460,2024-11-01,13472,4622,18094
5461,461,2024-11-01,35559,4722,40281
5462,462,2024-11-01,47030,4227,51257
5463,463,2024-11-01,12300,4360,16660
5464,464,2024-11-01,30131,3641,33772
5465,465,2024-11-01,43246,2722,45968
5466,466,2024-11-01,32775,4849,37624
5467,467,2024-11-01,19431,831,20262
5468,468,2024-11-01,23491,4355,27846
5469,469,2024-11-01,48818,3244,52062
5470,470,2024-11-01,11612,1609,13221
5471,471,2024-11-01,41296,2277,43573
5472,472,2024-11-01,42816,344,43160
5473,473,2024-11-01,49243,686,49929
5474,474,2024-11-01,43370,3992,47362
5475,475,2024-11-01,27994,3158,31152
5476,476,2024-11-01,21251,3232,24483
5477,477,2024-11-01,32785,1310,34095
5478,478,2024-11-01,39251,4843,44094
5479,479,2024-11-01,22056,528,22584
5480,480,2024-11-01,19808,3716,23524
5481,481,2024-11-01,37899,582,38481
5482,482,2024-11-01,31356,-3073,28283
5483,483,2024-11-01,20659,2577,23236
5484,484,2024-11-01,31464,3246,34710
5485,485,2024-11-01,44648,3086,47734
5486,486,2024-11-01,11551,3647,15198
5487,487,2024-11-01,38697,933,39630
5488,488,2024-11-01,15719,1546,17265
5489,489,2024-11-01,40504,2687,43191
5490,490,2024-11-01,26383,2298,28681
5491,491,2024-11-01,14496,4341,18837
5492,492,2024-11-01,14986,2962,17948
5493,493,2024-11-01,22382,124,22506
5494,494,2024-11-01,32573,1015,33588
5495,495,2024-11-01,28785,233,29018
5496,496,2024-11-01,42685,2783,45468
5497,497,2024-11-01,15295,3321,18616
5498,498,2024-11-01,16281,1640,17921
5499,499,2024-11-01,42729,2482,45211
5500,500,2024-11-01,18725,3728,22453
5501,1,2024-12-01,30987,1066,32053
5502,2,2024-12-01,45623,3883,49506
5503,3,2024-12-01,20141,2575,22716
5504,4,2024-12-01,15935,4680,20615
5505,5,2024-12-01,27555,1754,29309
5506,6,2024-12-01,20066,1349,21415
5507,7,2024-12-01,16109,3329,19438
5508,8,2024-12-01,12068,4269,16337
5509,9,2024-12-01,46049,1833,47882
5510,10,2024-12-01,21928,1459,23387
5511,11,2024-12-01,21682,2657,24339
5512,12,2024-12-01,12318,2617,14935
5513,13,2024-12-01,10437,1304,11741
5514,14,2024-12-01,40664,161,40825
5515,15,2024-12-01,44369,4912,49281
5516,16,2024-12-01,42062,4769,46831
5517,17,2024-12-01,33492,1667,35159
5518,18,2024-12-01,42114,3295,45409
5519,19,2024-12-01,49462,4981,54443
5520,20,2024-12-01,26606,4726,31332
5521,21,2024-12-01,26710,3739,30449
5522,22,2024-12-01,40963,3897,44860
5523,23,2024-12-01,17291,1459,18750
5524,24,2024-12-01,14337,719,15056
5525,25,2024-12-01,45263,4390,49653
5526,26,2024-12-01,11726,1504,13230
5527,27,2024-12-01,27423,786,28209
5528,28,2024-12-01,47802,2533,50335
5529,29,2024-12-01,0,2856,2856
5530,30,2024-12-01,43392,1420,44812
5531,31,2024-12-01,43443,-4091,39352
5532,32,2024-12-01,17759,3041,20800
5533,33,2024-12-01,30994,3113,34107
5534,34,2024-12-01,44686,554,45240
5535,35,2024-12-01,29620,3068,32688
5536,36,2024-12-01,38256,4402,42658
5537,37,2024-12-01,18362,3557,21919
5538,38,2024-12-01,42337,4485,46822
5539,39,2024-12-01,25629,726,26355
5540,40,2024-12-01,39036,4960,43996
5541,41,2024-12-01,24865,622,25487
5542,42,2024-12-01,25905,1055,26960
5543,43,2024-12-01,32930,2649,35579
5544,44,2024-12-01,28674,1530,30204
5545,45,2024-12-01,27988,3770,31758
5546,46,2024-12-01,10459,2919,13378
5547,47,2024-12-01,40411,208,40619
5548,48,2024-12-01,39020,2555,41575
5549,49,2024-12-01,16513,153,16666
5550,50,2024-12-01,11331,3077,14408
5551,51,2024-12-01,18573,4748,23321
5552,52,2024-12-01,49276,3274,52550
5553,53,2024-12-01,34860,2465,37325
5554,54,2024-12-01,21609,3513,25122
5555,55,2024-12-01,22367,2639,25006
5556,56,2024-12-01,23621,3771,27392
5557,57,2024-12-01,20178,1946,22124
5558,58,2024-12-01,36660,3050,39710
5559,59,2024-12-01,19584,4459,24043
5560,60,2024-12-01,0,3420,3420
5561,61,2024-12-01,27807,842,28649
5562,62,2024-12-01,18336,1954,20290
5563,63,2024-12-01,47032,1885,48917
5564,64,2024-12-01,21696,4424,26120
5565,65,2024-12-01,41295,3875,45170
5566,66,2024-12-01,33127,459,33586
5567,67,2024-12-01,19197,220,19417
5568,68,2024-12-01,39386,2024,41410
5569,69,2024-12-01,47315,961,48276
5570,70,2024-12-01,26111,4806,30917
5571,71,2024-12-01,10560,2466,13026
5572,72,2024-12-01,45552,2051,47603
5573,73,2024-12-01,22524,1623,24147
5574,74,2024-12-01,32286,1876,34162
5575,75,2024-12-01,27055,3925,30980
5576,76,2024-12-01,13817,3329,17146
5577,77,2024-12-01,21383,2836,24219
5578,78,2024-12-01,36625,2805,39430
5579,79,2024-12-01,39744,2197,41941
5580,80,2024-12-01,32559,368,32927
5581,81,2024-12-01,25604,789,26393
5582,82,2024-12-01,37778,1178,38956
5583,83,2024-12-01,13894,2491,16385
5584,84,2024-12-01,39066,3612,42678
5585,85,2024-12-01,32733,4629,37362
5586,86,2024-12-01,30359,4942,35301
5587,87,2024-12-01,49845,910,50755
5588,88,2024-12-01,19717,1617,21334
5589,89,2024-12-01,13968,3900,17868
5590,90,2024-12-01,45261,2830,48091
5591,91,2024-12-01,27905,3037,30942
5592,92,2024-12-01,26402,2015,28417
5593,93,2024-12-01,37247,2089,39336
5594,94,2024-12-01,33474,3062,36536
5595,95,2024-12-01,46697,4615,51312
5596,96,2024-12-01,23310,4547,27857
5597,97,2024-12-01,13373,971,14344
5598,98,2024-12-01,17499,1230,18729
5599,99,2024-12-01,42550,1867,44417
5600,100,2024-12-01,18830,4605,23435
5601,101,2024-12-01,45586,3659,49245
5602,102,2024-12-01,18494,803,19297
5603,103,2024-12-01,40381,2084,42465
5604,104,2024-12-01,31010,2183,33193
5605,105,2024-12-01,29312,3045,32357
5606,106,2024-12-01,47833,3444,51277
5607,107,2024-12-01,10054,4198,14252
5608,108,2024-12-01,24300,153,24453
5609,109,2024-12-01,37212,4807,42019
5610,110,2024-12-01,47959,3797,51756
5611,111,2024-12-01,29426,1786,31212
5612,112,2024-12-01,0,3724,3724
5613,113,2024-12-01,37304,1386,38690
5614,114,2024-12-01,29404,3198,32602
5615,115,2024-12-01,41786,3263,45049
5616,116,2024-12-01,25755,2403,28158
5617,117,2024-12-01,44846,4109,48955
5618,118,2024-12-01,35275,443,35718
5619,119,2024-12-01,20733,901,21634
5620,120,2024-12-01,32934,3392,36326
5621,121,2024-12-01,40499,3356,43855
5622,122,2024-12-01,49411,745,50156
5623,123,2024-12-01,35088,2998,38086
5624,124,2024-12-01,37948,378,38326
5625,125,2024-12-01,36181,4638,40819
5626,126,2024-12-01,31054,2831,33885
5627,127,2024-12-01,29088,3594,32682
5628,128,2024-12-01,23934,2888,26822
5629,129,2024-12-01,49158,827,49985
5630,130,2024-12-01,25332,3376,28708
5631,131,2024-12-01,18309,1946,20255
5632,132,2024-12-01,33092,987,34079
5633,133,2024-12-01,32538,1021,33559
5634,134,2024-12-01,22408,2835,25243
5635,135,2024-12-01,45423,3253,48676
5636,136,2024-12-01,43546,3412,46958
5637,137,2024-12-01,48887,2280,51167
5638,138,2024-12-01,46656,2353,49009
5639,139,2024-12-01,42516,4194,46710
5640,140,2024-12-01,13347,221,13568
5641,141,2024-12-01,25300,3446,28746
5642,142,2024-12-01,10031,1034,11065
5643,143,2024-12-01,16741,4342,21083
5644,144,2024-12-01,44067,691,44758
5645,145,2024-12-01,40023,3571,43594
5646,146,2024-12-01,29270,4562,33832
5647,147,2024-12-01,38644,-104,38540
5648,148,2024-12-01,13953,194,14147
5649,149,2024-12-01,38516,1426,39942
5650,150,2024-12-01,38689,2346,41035
5651,151,2024-12-01,44923,2614,47537
5652,152,2024-12-01,46273,2321,48594
5653,153,2024-12-01,43906,4493,48399
5654,154,2024-12-01,39068,2883,41951
5655,155,2024-12-01,11496,2516,14012
5656,156,2024-12-01,33321,2779,36100
5657,157,2024-12-01,33579,2934,36513
5658,158,2024-12-01,16702,1964,18666
5659,159,2024-12-01,48662,668,49330
5660,160,2024-12-01,46862,2076,48938
5661,161,2024-12-01,29027,3338,32365
5662,162,2024-12-01,17398,4684,22082
5663,163,2024-12-01,16635,110,16745
5664,164,2024-12-01,26886,1304,28190
5665,165,2024-12-01,31450,3591,35041
5666,166,2024-12-01,36057,2291,38348
5667,167,2024-12-01,40739,2892,43631
5668,168,2024-12-01,47982,214,48196
5669,169,2024-12-01,19257,3214,22471
5670,170,2024-12-01,41528,4662,46190
5671,171,2024-12-01,27060,2830,29890
5672,172,2024-12-01,10255,3885,14140
5673,173,2024-12-01,36929,2183,39112
5674,174,2024-12-01,32646,453,33099
5675,175,2024-12-01,36877,566,37443
5676,176,2024-12-01,32802,3086,35888
5677,177,2024-12-01,16797,4492,21289
5678,178,2024-12-01,18443,3104,21547
5679,179,2024-12-01,38149,2945,41094
5680,180,2024-12-01,19405,4564,23969
5681,181,2024-12-01,48934,4509,53443
5682,182,2024-12-01,40434,3206,43640
5683,183,2024-12-01,23158,-1787,21371
5684,184,2024-12-01,43636,2950,46586
5685,185,2024-12-01,27537,4146,31683
5686,186,2024-12-01,24151,1325,25476
5687,187,2024-12-01,23817,3848,27665
5688,188,2024-12-01,14819,3137,17956
5689,189,2024-12-01,45549,3823,49372
5690,190,2024-12-01,37037,2842,39879
5691,191,2024-12-01,49524,1393,50917
5692,192,2024-12-01,35644,218,35862
5693,193,2024-12-01,32031,4915,36946
5694,194,2024-12-01,40527,2492,43019
5695,195,2024-12-01,20630,4805,25435
5696,196,2024-12-01,0,3678,3678
5697,197,2024-12-01,32249,1731,33980
5698,198,2024-12-01,32950,63,33013
5699,199,2024-12-01,25613,4174,29787
5700,200,2024-12-01,33903,1840,35743
5701,201,2024-12-01,0,619,619
5702,202,2024-12-01,24484,333,24817
5703,203,2024-12-01,0,4911,4911
5704,204,2024-12-01,21708,1881,23589
5705,205,2024-12-01,39887,1222,41109
5706,206,2024-12-01,19086,2002,21088
5707,207,2024-12-01,35913,2922,38835
5708,208,2024-12-01,15309,2790,18099
5709,209,2024-12-01,24476,484,24960
5710,210,2024-12-01,42528,2363,44891
5711,211,2024-12-01,44807,2151,46958
5712,212,2024-12-01,31394,288,31682
5713,213,2024-12-01,22002,522,22524
5714,214,2024-12-01,13565,4064,17629
5715,215,2024-12-01,41179,1394,42573
5716,216,2024-12-01,35089,634,35723
5717,217,2024-12-01,36239,4419,40658
5718,218,2024-12-01,27891,3542,31433
5719,219,2024-12-01,28768,2424,31192
5720,220,2024-12-01,26244,2833,29077
5721,221,2024-12-01,29519,1434,30953
5722,222,2024-12-01,24781,40,24821
5723,223,2024-12-01,10044,233,10277
5724,224,2024-12-01,30922,3857,34779
5725,225,2024-12-01,49801,2097,51898
5726,226,2024-12-01,12298,2552,14850
5727,227,2024-12-01,46894,-1270,45624
5728,228,2024-12-01,42812,1085,43897
5729,229,2024-12-01,27596,1065,28661
5730,230,2024-12-01,17534,2561,20095
5731,231,2024-12-01,38009,168,38177
5732,232,2024-12-01,27449,1957,29406
5733,233,2024-12-01,29307,998,30305
5734,234,2024-12-01,38582,4082,42664
5735,235,2024-12-01,42330,386,42716
5736,236,2024-12-01,22221,4836,27057
5737,237,2024-12-01,34563,1023,35586
5738,238,2024-12-01,43244,3525,46769
5739,239,2024-12-01,16854,3051,19905
5740,240,2024-12-01,17652,4864,22516
5741,241,2024-12-01,29852,3968,33820
5742,242,2024-12-01,20309,906,21215
5743,243,2024-12-01,48411,252,48663
5744,244,2024-12-01,31601,2329,33930
5745,245,2024-12-01,21851,3381,25232
5746,246,2024-12-01,37624,70,37694
5747,247,2024-12-01,33918,194,34112
5748,248,2024-12-01,49143,4795,53938
5749,249,2024-12-01,23046,1024,24070
5750,250,2024-12-01,18703,4494,23197
5751,251,2024-12-01,13642,202,13844
5752,252,2024-12-01,27380,1441,28821
5753,253,2024-12-01,34344,965,35309
5754,254,2024-12-01,21969,-95,21874
5755,255,2024-12-01,41850,3184,45034
5756,256,2024-12-01,42664,1923,44587
5757,257,2024-12-01,24354,3277,27631
5758,258,2024-12-01,15448,2964,18412
5759,259,2024-12-01,36366,3457,39823
5760,260,2024-12-01,19983,5,19988
5761,261,2024-12-01,19837,2373,22210
5762,262,2024-12-01,31904,4395,36299
5763,263,2024-12-01,16347,3648,19995
5764,264,2024-12-01,39278,3145,42423
5765,265,2024-12-01,37259,134,37393
5766,266,2024-12-01,48938,609,49547
5767,267,2024-12-01,34200,2878,37078
5768,268,2024-12-01,23213,4338,27551
5769,269,2024-12-01,48180,1753,49933
5770,270,2024-12-01,18078,1554,19632
5771,271,2024-12-01,10570,4683,15253
5772,272,2024-12-01,23281,3535,26816
5773,273,2024-12-01,28284,3619,31903
5774,274,2024-12-01,44600,3628,48228
5775,275,2024-12-01,32067,3328,35395
5776,276,2024-12-01,11939,2502,14441
5777,277,2024-12-01,14132,3985,18117
5778,278,2024-12-01,25677,1334,27011
5779,279,2024-12-01,24547,801,25348
5780,280,2024-12-01,34855,1413,36268
5781,281,2024-12-01,26929,3095,30024
5782,282,2024-12-01,38303,1464,39767
5783,283,2024-12-01,18253,2566,20819
5784,284,2024-12-01,13950,3161,17111
5785,285,2024-12-01,0,3896,3896
5786,286,2024-12-01,46962,4579,51541
5787,287,2024-12-01,42943,864,43807
5788,288,2024-12-01,46345,-3443,42902
5789,289,2024-12-01,38742,1710,40452
5790,290,2024-12-01,12697,-2291,10406
5791,291,2024-12-01,39358,2706,42064
5792,292,2024-12-01,36081,2664,38745
5793,293,2024-12-01,16057,3470,19527
5794,294,2024-12-01,18585,2549,21134
5795,295,2024-12-01,12024,3865,15889
5796,296,2024-12-01,20695,3659,24354
5797,297,2024-12-01,17482,1743,19225
5798,298,2024-12-01,17286,1098,18384
5799,299,2024-12-01,16818,4229,21047
5800,300,2024-12-01,11018,3868,14886
5801,301,2024-12-01,32286,4041,36327
5802,302,2024-12-01,25845,1084,26929
5803,303,2024-12-01,15937,3580,19517
5804,304,2024-12-01,48864,4993,53857
5805,305,2024-12-01,36999,459,37458
5806,306,2024-12-01,34692,230,34922
5807,307,2024-12-01,32739,4954,37693
5808,308,2024-12-01,28887,2400,31287
5809,309,2024-12-01,31189,1558,32747
5810,310,2024-12-01,44735,1667,46402
5811,311,2024-12-01,11000,848,11848
5812,312,2024-12-01,12634,3925,16559
5813,313,2024-12-01,26203,3724,29927
5814,314,2024-12-01,21871,4328,26199
5815,315,2024-12-01,11968,4877,16845
5816,316,2024-12-01,12891,1120,14011
5817,317,2024-12-01,29498,3557,33055
5818,318,2024-12-01,39078,4432,43510
5819,319,2024-12-01,32258,2095,34353
5820,320,2024-12-01,37486,2468,39954
5821,321,2024-12-01,32591,132,32723
5822,322,2024-12-01,16497,3574,20071
5823,323,2024-12-01,42129,1896,44025
5824,324,2024-12-01,49933,2292,52225
5825,325,2024-12-01,11362,4996,16358
5826,326,2024-12-01,43674,2281,45955
5827,327,2024-12-01,11864,2820,14684
5828,328,2024-12-01,29889,1783,31672
5829,329,2024-12-01,38168,4106,42274
5830,330,2024-12-01,31626,4148,35774
5831,331,2024-12-01,43674,-57,43617
5832,332,2024-12-01,16270,2180,18450
5833,333,2024-12-01,40021,3078,43099
5834,334,2024-12-01,11348,2107,13455
5835,335,2024-12-01,15920,3641,19561
5836,336,2024-12-01,41260,2944,44204
5837,337,2024-12-01,22857,944,23801
5838,338,2024-12-01,28516,3912,32428
5839,339,2024-12-01,38278,4676,42954
5840,340,2024-12-01,41584,3361,44945
5841,341,2024-12-01,19841,1142,20983
5842,342,2024-12-01,41693,4384,46077
5843,343,2024-12-01,16389,211,16600
5844,344,2024-12-01,20071,3534,23605
5845,345,2024-12-01,25855,519,26374
5846,346,2024-12-01,26235,2043,28278
5847,347,2024-12-01,30616,1400,32016
5848,348,2024-12-01,25536,4935,30471
5849,349,2024-12-01,12224,4741,16965
5850,350,2024-12-01,12934,2567,15501
5851,351,2024-12-01,25630,3007,28637
5852,352,2024-12-01,16409,660,17069
5853,353,2024-12-01,11036,2131,13167
5854,354,2024-12-01,45772,1275,47047
5855,355,2024-12-01,19614,4939,24553
5856,356,2024-12-01,23428,4562,27990
5857,357,2024-12-01,26020,551,26571
5858,358,2024-12-01,13943,2379,16322
5859,359,2024-12-01,20287,2381,22668
5860,360,2024-12-01,28021,1880,29901
5861,361,2024-12-01,48413,-2700,45713
5862,362,2024-12-01,44379,3068,47447
5863,363,2024-12-01,21858,3961,25819
5864,364,2024-12-01,24521,2892,27413
5865,365,2024-12-01,22323,1113,23436
5866,366,2024-12-01,19187,806,19993
5867,367,2024-12-01,37508,2512,40020
5868,368,2024-12-01,12306,1774,14080
5869,369,2024-12-01,32547,3909,36456
5870,370,2024-12-01,24148,1179,25327
5871,371,2024-12-01,34986,2879,37865
5872,372,2024-12-01,45496,3352,48848
5873,373,2024-12-01,18230,1974,20204
5874,374,2024-12-01,48800,572,49372
5875,375,2024-12-01,27436,2238,29674
5876,376,2024-12-01,14065,339,14404
5877,377,2024-12-01,43585,160,43745
5878,378,2024-12-01,30698,2712,33410
5879,379,2024-12-01,10850,1033,11883
5880,380,2024-12-01,46740,1682,48422
5881,381,2024-12-01,22003,-3689,18314
5882,382,2024-12-01,22977,3546,26523
5883,383,2024-12-01,42847,480,43327
5884,384,2024-12-01,12386,1370,13756
5885,385,2024-12-01,17963,1849,19812
5886,386,2024-12-01,18461,1113,19574
5887,387,2024-12-01,23800,3596,27396
5888,388,2024-12-01,42097,3648,45745
5889,389,2024-12-01,45278,-4135,41143
5890,390,2024-12-01,18273,4221,22494
5891,391,2024-12-01,40395,4,40399
5892,392,2024-12-01,25080,2191,27271
5893,393,2024-12-01,30321,-3330,26991
5894,394,2024-12-01,25061,2696,27757
5895,395,2024-12-01,16076,1335,17411
5896,396,2024-12-01,32456,3904,36360
5897,397,2024-12-01,27227,3317,30544
5898,398,2024-12-01,29186,769,29955
5899,399,2024-12-01,28374,899,29273
5900,400,2024-12-01,34914,2773,37687
5901,401,2024-12-01,18023,3958,21981
5902,402,2024-12-01,25562,2184,27746
5903,403,2024-12-01,26151,463,26614
5904,404,2024-12-01,19731,2489,22220
5905,405,2024-12-01,37210,757,37967
5906,406,2024-12-01,41954,3868,45822
5907,407,2024-12-01,20135,4239,24374
5908,408,2024-12-01,15395,1204,16599
5909,409,2024-12-01,24353,876,25229
5910,410,2024-12-01,34387,459,34846
5911,411,2024-12-01,18886,907,19793
5912,412,2024-12-01,13071,2004,15075
5913,413,2024-12-01,49359,2416,51775
5914,414,2024-12-01,24621,4062,28683
5915,415,2024-12-01,23973,4273,28246
5916,416,2024-12-01,31671,1776,33447
5917,417,2024-12-01,24910,3195,28105
5918,418,2024-12-01,31095,3001,34096
5919,419,2024-12-01,17131,1135,18266
5920,420,2024-12-01,24742,3597,28339
5921,421,2024-12-01,39506,3923,43429
5922,422,2024-12-01,23357,1482,24839
5923,423,2024-12-01,16720,741,17461
5924,424,2024-12-01,48912,1722,50634
5925,425,2024-12-01,48434,4083,52517
5926,426,2024-12-01,44995,406,45401
5927,427,2024-12-01,11862,43,11905
5928,428,2024-12-01,32881,3702,36583
5929,429,2024-12-01,36555,4615,41170
5930,430,2024-12-01,12905,2729,15634
5931,431,2024-12-01,28575,525,29100
5932,432,2024-12-01,43597,1561,45158
5933,433,2024-12-01,17091,3080,20171
5934,434,2024-12-01,41153,2388,43541
5935,435,2024-12-01,19528,187,19715
5936,436,2024-12-01,43894,1313,45207
5937,437,2024-12-01,31830,1039,32869
5938,438,2024-12-01,40902,2173,43075
5939,439,2024-12-01,48984,541,49525
5940,440,2024-12-01,21944,4190,26134
5941,441,2024-12-01,38375,3732,42107
5942,442,2024-12-01,48115,1375,49490
5943,443,2024-12-01,26593,4838,31431
5944,444,2024-12-01,19512,4607,24119
5945,445,2024-12-01,43332,4936,48268
5946,446,2024-12-01,35136,3735,38871
5947,447,2024-12-01,20930,2710,23640
5948,448,2024-12-01,26539,4272,30811
5949,449,2024-12-01,14755,2856,17611
5950,450,2024-12-01,22948,741,23689
5951,451,2024-12-01,47274,1298,48572
5952,452,2024-12-01,25878,794,26672
5953,453,2024-12-01,42097,4456,46553
5954,454,2024-12-01,11705,2541,14246
5955,455,2024-12-01,34412,2734,37146
5956,456,2024-12-01,35885,1826,37711
5957,457,2024-12-01,24456,3976,28432
5958,458,2024-12-01,14051,4258,18309
5959,459,2024-12-01,26361,504,26865
5960,460,2024-12-01,34576,1458,36034
5961,461,2024-12-01,45553,4324,49877
5962,462,2024-12-01,33757,726,34483
5963,463,2024-12-01,42805,1909,44714
5964,464,2024-12-01,24530,1655,26185
5965,465,2024-12-01,15797,1239,17036
5966,466,2024-12-01,45094,4066,49160
5967,467,2024-12-01,33562,1543,35105
5968,468,2024-12-01,37813,4327,42140
5969,469,2024-12-01,43749,2507,46256
5970,470,2024-12-01,34492,4789,39281
5971,471,2024-12-01,35977,3066,39043
5972,472,2024-12-01,41445,3739,45184
5973,473,2024-12-01,13902,2224,16126
5974,474,2024-12-01,46737,3437,50174
5975,475,2024-12-01,41517,3347,44864
5976,476,2024-12-01,33937,777,34714
5977,477,2024-12-01,46732,3287,50019
5978,478,2024-12-01,49762,597,50359
5979,479,2024-12-01,23427,4896,28323
5980,480,2024-12-01,48411,4601,53012
5981,481,2024-12-01,15989,740,16729
5982,482,2024-12-01,35723,1678,37401
5983,483,2024-12-01,16123,4405,20528
5984,484,2024-12-01,45913,4397,50310
5985,485,2024-12-01,49189,4243,53432
5986,486,2024-12-01,25708,2670,28378
5987,487,2024-12-01,32718,2575,35293
5988,488,2024-12-01,44546,4916,49462
5989,489,2024-12-01,33651,2836,36487
5990,490,2024-12-01,44343,4467,48810
5991,491,2024-12-01,21900,1236,23136
5992,492,2024-12-01,34513,3605,38118
5993,493,2024-12-01,32896,4802,37698
5994,494,2024-12-01,26536,2249,28785
5995,495,2024-12-01,36327,2215,38542
5996,496,2024-12-01,20233,3389,23622
5997,497,2024-12-01,49341,3279,52620
5998,498,2024-12-01,28588,4007,32595
5999,499,2024-12-01,24604,3771,28375
6000,500,2024-12-01,30556,1878,32434
6001,1,2025-01-01,15610,2272,17882
6002,2,2025-01-01,16423,1478,17901
6003,3,2025-01-01,22414,1549,23963
6004,4,2025-01-01,12656,1842,14498
6005,5,2025-01-01,23381,2627,26008
6006,6,2025-01-01,26654,3533,30187
6007,7,2025-01-01,18187,4292,22479
6008,8,2025-01-01,47604,3374,50978
6009,9,2025-01-01,34742,4651,39393
6010,10,2025-01-01,24405,4613,29018
6011,11,2025-01-01,41877,880,42757
6012,12,2025-01-01,23848,1490,25338
6013,13,2025-01-01,43560,636,44196
6014,14,2025-01-01,34354,1252,35606
6015,15,2025-01-01,32661,3573,36234
6016,16,2025-01-01,37656,917,38573
6017,17,2025-01-01,39805,3464,43269
6018,18,2025-01-01,30847,2199,33046
6019,19,2025-01-01,44332,4309,48641
6020,20,2025-01-01,25706,4715,30421
6021,21,2025-01-01,49150,2259,51409
6022,22,2025-01-01,35156,1834,36990
6023,23,2025-01-01,15267,4638,19905
6024,24,2025-01-01,38239,3924,42163
6025,25,2025-01-01,35845,2064,37909
6026,26,2025-01-01,32437,2482,34919
6027,27,2025-01-01,47655,640,48295
6028,28,2025-01-01,10176,2788,12964
6029,29,2025-01-01,14221,3971,18192
6030,30,2025-01-01,19882,900,20782
6031,31,2025-01-01,17933,3315,21248
6032,32,2025-01-01,44177,2813,46990
6033,33,2025-01-01,43251,4181,47432
6034,34,2025-01-01,11383,3983,15366
6035,35,2025-01-01,29139,3486,32625
6036,36,2025-01-01,19277,1548,20825
6037,37,2025-01-01,39683,3806,43489
6038,38,2025-01-01,43167,2272,45439
6039,39,2025-01-01,21442,358,21800
6040,40,2025-01-01,14555,2425,16980
6041,41,2025-01-01,45110,1426,46536
6042,42,2025-01-01,21388,1111,22499
6043,43,2025-01-01,39907,2996,42903
6044,44,2025-01-01,27997,3698,31695
6045,45,2025-01-01,24980,2689,27669
6046,46,2025-01-01,17031,3862,20893
6047,47,2025-01-01,19068,2495,21563
6048,48,2025-01-01,22174,2787,24961
6049,49,2025-01-01,16798,2834,19632
6050,50,2025-01-01,35568,1373,36941
6051,51,2025-01-01,11549,3139,14688
6052,52,2025-01-01,35204,-250,34954
6053,53,2025-01-01,21597,1316,22913
6054,54,2025-01-01,32779,3786,36565
6055,55,2025-01-01,34267,601,34868
6056,56,2025-01-01,19676,2159,21835
6057,57,2025-01-01,18585,1221,19806
6058,58,2025-01-01,33913,945,34858
6059,59,2025-01-01,32995,4958,37953
6060,60,2025-01-01,28449,2235,30684
6061,61,2025-01-01,20822,3136,23958
6062,62,2025-01-01,25507,738,26245
6063,63,2025-01-01,23358,2498,25856
6064,64,2025-01-01,17541,4750,22291
6065,65,2025-01-01,24147,1815,25962
6066,66,2025-01-01,47967,3544,51511
6067,67,2025-01-01,34190,626,34816
6068,68,2025-01-01,29267,3429,32696
6069,69,2025-01-01,18096,1841,19937
6070,70,2025-01-01,49936,2271,52207
6071,71,2025-01-01,15158,4100,19258
6072,72,2025-01-01,40167,3377,43544
6073,73,2025-01-01,43148,4119,47267
6074,74,2025-01-01,18658,6,18664
6075,75,2025-01-01,11318,340,11658
6076,76,2025-01-01,27090,2036,29126
6077,77,2025-01-01,18592,3033,21625
6078,78,2025-01-01,17443,4612,22055
6079,79,2025-01-01,22052,2100,24152
6080,80,2025-01-01,27716,530,28246
6081,81,2025-01-01,15901,4909,20810
6082,82,2025-01-01,39168,2975,42143
6083,83,2025-01-01,48697,4704,53401
6084,84,2025-01-01,42342,502,42844
6085,85,2025-01-01,44003,3052,47055
6086,86,2025-01-01,45120,4457,49577
6087,87,2025-01-01,35975,4026,40001
6088,88,2025-01-01,33471,4726,38197
6089,89,2025-01-01,30110,2633,32743
6090,90,2025-01-01,34845,864,35709
6091,91,2025-01-01,41173,3853,45026
6092,92,2025-01-01,46716,2581,49297
6093,93,2025-01-01,48002,763,48765
6094,94,2025-01-01,24466,4228,28694
6095,95,2025-01-01,43606,1317,44923
6096,96,2025-01-01,11536,3854,15390
6097,97,2025-01-01,29235,1875,31110
6098,98,2025-01-01,12009,905,12914
6099,99,2025-01-01,45846,4144,49990
6100,100,2025-01-01,27711,2728,30439
6101,101,2025-01-01,37597,1114,38711
6102,102,2025-01-01,46345,1699,48044
6103,103,2025-01-01,13810,1878,15688
6104,104,2025-01-01,17903,2409,20312
6105,105,2025-01-01,37242,4214,41456
6106,106,2025-01-01,13755,-3294,10461
6107,107,2025-01-01,45849,4663,50512
6108,108,2025-01-01,25999,3984,29983
6109,109,2025-01-01,23314,4992,28306
6110,110,2025-01-01,19530,3674,23204
6111,111,2025-01-01,45913,3847,49760
6112,112,2025-01-01,28611,20,28631
6113,113,2025-01-01,10173,4999,15172
6114,114,2025-01-01,16494,4407,20901
6115,115,2025-01-01,14257,3652,17909
6116,116,2025-01-01,45454,2226,47680
6117,117,2025-01-01,38136,3027,41163
6118,118,2025-01-01,49208,114,49322
6119,119,2025-01-01,37535,4827,42362
6120,120,2025-01-01,27562,712,28274
6121,121,2025-01-01,47221,4377,51598
6122,122,2025-01-01,13696,1785,15481
6123,123,2025-01-01,14917,2414,17331
6124,124,2025-01-01,36139,2061,38200
6125,125,2025-01-01,36878,4759,41637
6126,126,2025-01-01,15402,2367,17769
6127,127,2025-01-01,37209,3458,40667
6128,128,2025-01-01,35011,1283,36294
6129,129,2025-01-01,41125,2204,43329
6130,130,2025-01-01,0,4990,4990
6131,131,2025-01-01,39814,1789,41603
6132,132,2025-01-01,19712,1621,21333
6133,133,2025-01-01,30060,2854,32914
6134,134,2025-01-01,17539,1322,18861
6135,135,2025-01-01,19473,1733,21206
6136,136,2025-01-01,10270,1926,12196
6137,137,2025-01-01,18194,4978,23172
6138,138,2025-01-01,34175,2586,36761
6139,139,2025-01-01,42011,2291,44302
6140,140,2025-01-01,45955,3681,49636
6141,141,2025-01-01,32950,43,32993
6142,142,2025-01-01,34403,4507,38910
6143,143,2025-01-01,18644,4838,23482
6144,144,2025-01-01,35418,4627,40045
6145,145,2025-01-01,33357,2987,36344
6146,146,2025-01-01,27461,2439,29900
6147,147,2025-01-01,28545,4819,33364
6148,148,2025-01-01,12496,-4882,7614
6149,149,2025-01-01,13161,1553,14714
6150,150,2025-01-01,37278,2973,40251
6151,151,2025-01-01,34572,1956,36528
6152,152,2025-01-01,47493,2075,49568
6153,153,2025-01-01,46509,3221,49730
6154,154,2025-01-01,12110,4282,16392
6155,155,2025-01-01,48129,1968,50097
6156,156,2025-01-01,20354,564,20918
6157,157,2025-01-01,26110,2976,29086
6158,158,2025-01-01,37563,-3502,34061
6159,159,2025-01-01,19447,1286,20733
6160,160,2025-01-01,31135,1436,32571
6161,161,2025-01-01,46885,1359,48244
6162,162,2025-01-01,43361,3256,46617
6163,163,2025-01-01,25961,3912,29873
6164,164,2025-01-01,29052,1828,30880
6165,165,2025-01-01,26944,2278,29222
6166,166,2025-01-01,24994,2325,27319
6167,167,2025-01-01,29457,2907,32364
6168,168,2025-01-01,16489,3751,20240
6169,169,2025-01-01,17025,610,17635
6170,170,2025-01-01,41563,4527,46090
6171,171,2025-01-01,36699,1727,38426
6172,172,2025-01-01,32899,136,33035
6173,173,2025-01-01,12747,158,12905
6174,174,2025-01-01,44194,1800,45994
6175,175,2025-01-01,19913,1826,21739
6176,176,2025-01-01,39293,4129,43422
6177,177,2025-01-01,32859,3407,36266
6178,178,2025-01-01,42814,-4828,37986
6179,179,2025-01-01,13839,4885,18724
6180,180,2025-01-01,18585,3466,22051
6181,181,2025-01-01,33190,3755,36945
6182,182,2025-01-01,25330,-1511,23819
6183,183,2025-01-01,16484,88,16572
6184,184,2025-01-01,33358,220,33578
6185,185,2025-01-01,31019,1817,32836
6186,186,2025-01-01,16530,3032,19562
6187,187,2025-01-01,20759,4196,24955
6188,188,2025-01-01,17440,-4981,12459
6189,189,2025-01-01,19259,2887,22146
6190,190,2025-01-01,25585,4869,30454
6191,191,2025-01-01,18726,2955,21681
6192,192,2025-01-01,43818,3035,46853
6193,193,2025-01-01,46181,1654,47835
6194,194,2025-01-01,49101,779,49880
6195,195,2025-01-01,28436,4284,32720
6196,196,2025-01-01,47131,2121,49252
6197,197,2025-01-01,27794,4130,31924
6198,198,2025-01-01,32792,3558,36350
6199,199,2025-01-01,21975,1302,23277
6200,200,2025-01-01,19403,2677,22080
6201,201,2025-01-01,38989,4037,43026
6202,202,2025-01-01,14591,224,14815
6203,203,2025-01-01,15402,4869,20271
6204,204,2025-01-01,30160,4665,34825
6205,205,2025-01-01,47629,4069,51698
6206,206,2025-01-01,27410,4279,31689
6207,207,2025-01-01,37772,4394,42166
6208,208,2025-01-01,13740,-4195,9545
6209,209,2025-01-01,35689,1648,37337
6210,210,2025-01-01,36962,-2580,34382
6211,211,2025-01-01,13178,1970,15148
6212,212,2025-01-01,39319,168,39487
6213,213,2025-01-01,19359,1223,20582
6214,214,2025-01-01,38474,2405,40879
6215,215,2025-01-01,45750,2713,48463
6216,216,2025-01-01,45170,1236,46406
6217,217,2025-01-01,41605,4448,46053
6218,218,2025-01-01,29120,2578,31698
6219,219,2025-01-01,31258,3524,34782
6220,220,2025-01-01,28511,2648,31159
6221,221,2025-01-01,44213,3796,48009
6222,222,2025-01-01,47071,103,47174
6223,223,2025-01-01,42856,1766,44622
6224,224,2025-01-01,34103,2996,37099
6225,225,2025-01-01,10763,4959,15722
6226,226,2025-01-01,11204,3539,14743
6227,227,2025-01-01,45792,2178,47970
6228,228,2025-01-01,32987,1444,34431
6229,229,2025-01-01,16032,3180,19212
6230,230,2025-01-01,42621,1749,44370
6231,231,2025-01-01,29698,1748,31446
6232,232,2025-01-01,28984,4925,33909
6233,233,2025-01-01,31289,4222,35511
6234,234,2025-01-01,40029,4946,44975
6235,235,2025-01-01,26220,1189,27409
6236,236,2025-01-01,47962,1045,49007
6237,237,2025-01-01,30491,4078,34569
6238,238,2025-01-01,30178,2830,33008
6239,239,2025-01-01,42908,2768,45676
6240,240,2025-01-01,12249,1465,13714
6241,241,2025-01-01,22694,2946,25640
6242,242,2025-01-01,45654,4060,49714
6243,243,2025-01-01,39778,4133,43911
6244,244,2025-01-01,12051,1560,13611
6245,245,2025-01-01,37490,2392,39882
6246,246,2025-01-01,23357,3334,26691
6247,247,2025-01-01,44884,2747,47631
6248,248,2025-01-01,43373,3585,46958
6249,249,2025-01-01,38364,2042,40406
6250,250,2025-01-01,42618,477,43095
6251,251,2025-01-01,24829,1592,26421
6252,252,2025-01-01,28967,1508,30475
6253,253,2025-01-01,12976,1387,14363
6254,254,2025-01-01,36846,4912,41758
6255,255,2025-01-01,11321,2730,14051
6256,256,2025-01-01,38850,1176,40026
6257,257,2025-01-01,22753,3768,26521
6258,258,2025-01-01,32709,1870,34579
6259,259,2025-01-01,11005,4572,15577
6260,260,2025-01-01,36713,2639,39352
6261,261,2025-01-01,46219,42,46261
6262,262,2025-01-01,37674,3377,41051
6263,263,2025-01-01,41601,2417,44018
6264,264,2025-01-01,35852,3839,39691
6265,265,2025-01-01,38831,308,39139
6266,266,2025-01-01,21845,4050,25895
6267,267,2025-01-01,40656,4888,45544
6268,268,2025-01-01,38534,812,39346
6269,269,2025-01-01,41812,3900,45712
6270,270,2025-01-01,48115,-4223,43892
6271,271,2025-01-01,31684,4059,35743
6272,272,2025-01-01,30503,421,30924
6273,273,2025-01-01,28407,3260,31667
6274,274,2025-01-01,45308,3539,48847
6275,275,2025-01-01,30373,645,31018
6276,276,2025-01-01,14703,401,15104
6277,277,2025-01-01,36329,2896,39225
6278,278,2025-01-01,16345,3964,20309
6279,279,2025-01-01,37914,2762,40676
6280,280,2025-01-01,48023,592,48615
6281,281,2025-01-01,38927,3299,42226
6282,282,2025-01-01,29929,4798,34727
6283,283,2025-01-01,23842,1373,25215
6284,284,2025-01-01,12788,3593,16381
6285,285,2025-01-01,10600,4086,14686
6286,286,2025-01-01,38934,3848,42782
6287,287,2025-01-01,20884,2994,23878
6288,288,2025-01-01,46571,2972,49543
6289,289,2025-01-01,38593,4804,43397
6290,290,2025-01-01,26440,-4058,22382
6291,291,2025-01-01,36812,2337,39149
6292,292,2025-01-01,15545,4553,20098
6293,293,2025-01-01,32353,3049,35402
6294,294,2025-01-01,21993,3874,25867
6295,295,2025-01-01,28112,558,28670
6296,296,2025-01-01,37091,4508,41599
6297,297,2025-01-01,45109,1960,47069
6298,298,2025-01-01,29618,1037,30655
6299,299,2025-01-01,47636,1387,49023
6300,300,2025-01-01,21571,346,21917
6301,301,2025-01-01,17671,4359,22030
6302,302,2025-01-01,40849,3576,44425
6303,303,2025-01-01,24400,4366,28766
6304,304,2025-01-01,26034,1058,27092
6305,305,2025-01-01,24818,275,25093
6306,306,2025-01-01,30615,2711,33326
6307,307,2025-01-01,25070,4602,29672
6308,308,2025-01-01,44716,3252,47968
6309,309,2025-01-01,10311,4105,14416
6310,310,2025-01-01,27320,4924,32244
6311,311,2025-01-01,12966,4899,17865
6312,312,2025-01-01,46947,265,47212
6313,313,2025-01-01,18089,4136,22225
6314,314,2025-01-01,49611,2463,52074
6315,315,2025-01-01,10944,1406,12350
6316,316,2025-01-01,15895,93,15988
6317,317,2025-01-01,0,4396,4396
6318,318,2025-01-01,27934,609,28543
6319,319,2025-01-01,40016,1144,41160
6320,320,2025-01-01,27111,4759,31870
6321,321,2025-01-01,17335,3240,20575
6322,322,2025-01-01,14444,3407,17851
6323,323,2025-01-01,15311,3154,18465
6324,324,2025-01-01,18059,387,18446
6325,325,2025-01-01,42416,4068,46484
6326,326,2025-01-01,25076,2360,27436
6327,327,2025-01-01,22185,1950,24135
6328,328,2025-01-01,12640,3626,16266
6329,329,2025-01-01,28893,4662,33555
6330,330,2025-01-01,14986,1284,16270
6331,331,2025-01-01,11021,2719,13740
6332,332,2025-01-01,33315,1267,34582
6333,333,2025-01-01,37871,2784,40655
6334,334,2025-01-01,31250,1227,32477
6335,335,2025-01-01,25470,1737,27207
6336,336,2025-01-01,31115,4868,35983
6337,337,2025-01-01,21214,2085,23299
6338,338,2025-01-01,31853,2085,33938
6339,339,2025-01-01,29092,1910,31002
6340,340,2025-01-01,23805,2072,25877
6341,341,2025-01-01,22767,120,22887
6342,342,2025-01-01,22284,2490,24774
6343,343,2025-01-01,24494,3025,27519
6344,344,2025-01-01,12518,3459,15977
6345,345,2025-01-01,28741,2214,30955
6346,346,2025-01-01,14359,235,14594
6347,347,2025-01-01,47553,1565,49118
6348,348,2025-01-01,25424,2331,27755
6349,349,2025-01-01,13544,3752,17296
6350,350,2025-01-01,29538,3222,32760
6351,351,2025-01-01,11869,4913,16782
6352,352,2025-01-01,26284,4762,31046
6353,353,2025-01-01,36211,1801,38012
6354,354,2025-01-01,49646,2860,52506
6355,355,2025-01-01,39520,656,40176
6356,356,2025-01-01,29633,1477,31110
6357,357,2025-01-01,47149,3812,50961
6358,358,2025-01-01,16838,3175,20013
6359,359,2025-01-01,0,435,435
6360,360,2025-01-01,42017,2938,44955
6361,361,2025-01-01,49899,3402,53301
6362,362,2025-01-01,48127,772,48899
6363,363,2025-01-01,0,409,409
6364,364,2025-01-01,19446,228,19674
6365,365,2025-01-01,41597,3938,45535
6366,366,2025-01-01,19691,2588,22279
6367,367,2025-01-01,10223,325,10548
6368,368,2025-01-01,18558,1822,20380
6369,369,2025-01-01,15761,2854,18615
6370,370,2025-01-01,15322,222,15544
6371,371,2025-01-01,43421,2104,45525
6372,372,2025-01-01,14496,4743,19239
6373,373,2025-01-01,20001,895,20896
6374,374,2025-01-01,11672,1685,13357
6375,375,2025-01-01,18433,4102,22535
6376,376,2025-01-01,27029,1042,28071
6377,377,2025-01-01,20583,4604,25187
6378,378,2025-01-01,32984,3062,36046
6379,379,2025-01-01,23783,2779,26562
6380,380,2025-01-01,19231,2975,22206
6381,381,2025-01-01,45406,3074,48480
6382,382,2025-01-01,43900,4518,48418
6383,383,2025-01-01,41956,3468,45424
6384,384,2025-01-01,25925,447,26372
6385,385,2025-01-01,35107,2020,37127
6386,386,2025-01-01,43165,3940,47105
6387,387,2025-01-01,20275,1993,22268
6388,388,2025-01-01,19616,1938,21554
6389,389,2025-01-01,24041,3124,27165
6390,390,2025-01-01,28601,1421,30022
6391,391,2025-01-01,12167,4544,16711
6392,392,2025-01-01,13368,2799,16167
6393,393,2025-01-01,15287,4239,19526
6394,394,2025-01-01,26870,4221,31091
6395,395,2025-01-01,43720,2943,46663
6396,396,2025-01-01,22000,183,22183
6397,397,2025-01-01,38799,1623,40422
6398,398,2025-01-01,36940,3889,40829
6399,399,2025-01-01,31076,1488,32564
6400,400,2025-01-01,29344,2913,32257
6401,401,2025-01-01,44274,2849,47123
6402,402,2025-01-01,27377,2554,29931
6403,403,2025-01-01,20661,741,21402
6404,404,2025-01-01,37557,1274,38831
6405,405,2025-01-01,36786,729,37515
6406,406,2025-01-01,15341,2964,18305
6407,407,2025-01-01,39795,1273,41068
6408,408,2025-01-01,22590,2893,25483
6409,409,2025-01-01,39760,4149,43909
6410,410,2025-01-01,37330,2866,40196
6411,411,2025-01-01,10193,2712,12905
6412,412,2025-01-01,33953,1077,35030
6413,413,2025-01-01,35877,4694,40571
6414,414,2025-01-01,13184,1933,15117
6415,415,2025-01-01,37411,3097,40508
6416,416,2025-01-01,45080,2110,47190
6417,417,2025-01-01,10818,3351,14169
6418,418,2025-01-01,23324,1341,24665
6419,419,2025-01-01,22536,2103,24639
6420,420,2025-01-01,47009,683,47692
6421,421,2025-01-01,47305,1169,48474
6422,422,2025-01-01,16810,293,17103
6423,423,2025-01-01,35023,2325,37348
6424,424,2025-01-01,22995,2533,25528
6425,425,2025-01-01,29835,194,30029
6426,426,2025-01-01,46496,44,46540
6427,427,2025-01-01,24807,4027,28834
6428,428,2025-01-01,30848,2497,33345
6429,429,2025-01-01,47727,2611,50338
6430,430,2025-01-01,34125,2208,36333
6431,431,2025-01-01,30838,1915,32753
6432,432,2025-01-01,0,470,470
6433,433,2025-01-01,15642,2348,17990
6434,434,2025-01-01,42147,4926,47073
6435,435,2025-01-01,31910,3754,35664
6436,436,2025-01-01,36452,1681,38133
6437,437,2025-01-01,10195,3527,13722
6438,438,2025-01-01,14682,3676,18358
6439,439,2025-01-01,20091,1517,21608
6440,440,2025-01-01,16552,1054,17606
6441,441,2025-01-01,25294,439,25733
6442,442,2025-01-01,49847,1148,50995
6443,443,2025-01-01,20819,1991,22810
6444,444,2025-01-01,21938,1265,23203
6445,445,2025-01-01,31718,3388,35106
6446,446,2025-01-01,33842,436,34278
6447,447,2025-01-01,23359,4544,27903
6448,448,2025-01-01,43056,2924,45980
6449,449,2025-01-01,15436,989,16425
6450,450,2025-01-01,33576,2424,36000
6451,451,2025-01-01,26294,411,26705
6452,452,2025-01-01,24862,-2183,22679
6453,453,2025-01-01,42397,3995,46392
6454,454,2025-01-01,15474,688,16162
6455,455,2025-01-01,31640,1331,32971
6456,456,2025-01-01,27953,2092,30045
6457,457,2025-01-01,11820,4688,16508
6458,458,2025-01-01,48975,2881,51856
6459,459,2025-01-01,22941,3941,26882
6460,460,2025-01-01,34286,956,35242
6461,461,2025-01-01,15052,3424,18476
6462,462,2025-01-01,0,2144,2144
6463,463,2025-01-01,10133,2904,13037
6464,464,2025-01-01,33449,4307,37756
6465,465,2025-01-01,43305,62,43367
6466,466,2025-01-01,14757,4986,19743
6467,467,2025-01-01,24497,2502,26999
6468,468,2025-01-01,11033,941,11974
6469,469,2025-01-01,45189,3216,48405
6470,470,2025-01-01,36742,-2989,33753
6471,471,2025-01-01,46197,1396,47593
6472,472,2025-01-01,29210,2305,31515
6473,473,2025-01-01,34777,1743,36520
6474,474,2025-01-01,39065,-1912,37153
6475,475,2025-01-01,10287,3907,14194
6476,476,2025-01-01,32558,1751,34309
6477,477,2025-01-01,39665,3358,43023
6478,478,2025-01-01,19172,3163,22335
6479,479,2025-01-01,35794,2000,37794
6480,480,2025-01-01,28926,4802,33728
6481,481,2025-01-01,38968,90,39058
6482,482,2025-01-01,36473,3707,40180
6483,483,2025-01-01,25753,1207,26960
6484,484,2025-01-01,33042,1903,34945
6485,485,2025-01-01,27108,108,27216
6486,486,2025-01-01,22572,3967,26539
6487,487,2025-01-01,49979,4159,54138
6488,488,2025-01-01,25183,2715,27898
6489,489,2025-01-01,0,4232,4232
6490,490,2025-01-01,43117,4212,47329
6491,491,2025-01-01,11165,199,11364
6492,492,2025-01-01,18448,2636,21084
6493,493,2025-01-01,18911,2259,21170
6494,494,2025-01-01,33435,496,33931
6495,495,2025-01-01,31383,4434,35817
6496,496,2025-01-01,48722,3153,51875
6497,497,2025-01-01,11308,1984,13292
6498,498,2025-01-01,39821,4784,44605
6499,499,2025-01-01,28466,718,29184
6500,500,2025-01-01,17580,-2674,14906
6501,1,2025-02-01,38983,4876,43859
6502,2,2025-02-01,12547,2523,15070
6503,3,2025-02-01,25390,1907,27297
6504,4,2025-02-01,44957,1854,46811
6505,5,2025-02-01,12527,1501,14028
6506,6,2025-02-01,10996,1184,12180
6507,7,2025-02-01,18175,4666,22841
6508,8,2025-02-01,32912,3899,36811
6509,9,2025-02-01,40205,1179,41384
6510,10,2025-02-01,21051,-1850,19201
6511,11,2025-02-01,21537,1130,22667
6512,12,2025-02-01,14166,4908,19074
6513,13,2025-02-01,33160,3594,36754
6514,14,2025-02-01,49060,3257,52317
6515,15,2025-02-01,46083,4147,50230
6516,16,2025-02-01,37128,1086,38214
6517,17,2025-02-01,10853,3062,13915
6518,18,2025-02-01,38329,4959,43288
6519,19,2025-02-01,0,322,322
6520,20,2025-02-01,24704,1046,25750
6521,21,2025-02-01,23047,3945,26992
6522,22,2025-02-01,10972,3631,14603
6523,23,2025-02-01,47272,3941,51213
6524,24,2025-02-01,19975,3923,23898
6525,25,2025-02-01,33529,3035,36564
6526,26,2025-02-01,48973,-4358,44615
6527,27,2025-02-01,17868,60,17928
6528,28,2025-02-01,38885,1307,40192
6529,29,2025-02-01,29823,2818,32641
6530,30,2025-02-01,28330,1331,29661
6531,31,2025-02-01,36116,773,36889
6532,32,2025-02-01,43287,1723,45010
6533,33,2025-02-01,10547,4874,15421
6534,34,2025-02-01,11434,3999,15433
6535,35,2025-02-01,17965,2767,20732
6536,36,2025-02-01,24783,-1970,22813
6537,37,2025-02-01,16054,1770,17824
6538,38,2025-02-01,25977,717,26694
6539,39,2025-02-01,23688,1639,25327
6540,40,2025-02-01,48260,2056,50316
6541,41,2025-02-01,32289,3267,35556
6542,42,2025-02-01,24381,2673,27054
6543,43,2025-02-01,44820,1933,46753
6544,44,2025-02-01,31214,4768,35982
6545,45,2025-02-01,27733,913,28646
6546,46,2025-02-01,33851,3462,37313
6547,47,2025-02-01,29900,2460,32360
6548,48,2025-02-01,16802,3912,20714
6549,49,2025-02-01,13683,4956,18639
6550,50,2025-02-01,42934,4188,47122
6551,51,2025-02-01,38039,2843,40882
6552,52,2025-02-01,10714,2281,12995
6553,53,2025-02-01,19783,991,20774
6554,54,2025-02-01,29042,471,29513
6555,55,2025-02-01,21701,1527,23228
6556,56,2025-02-01,37159,3465,40624
6557,57,2025-02-01,44067,2195,46262
6558,58,2025-02-01,33453,991,34444
6559,59,2025-02-01,44159,3582,47741
6560,60,2025-02-01,47716,3714,51430
6561,61,2025-02-01,21117,3353,24470
6562,62,2025-02-01,13248,2948,16196
6563,63,2025-02-01,26280,701,26981
6564,64,2025-02-01,11084,325,11409
6565,65,2025-02-01,49959,1457,51416
6566,66,2025-02-01,12214,181,12395
6567,67,2025-02-01,41668,4776,46444
6568,68,2025-02-01,21209,1393,22602
6569,69,2025-02-01,30387,2664,33051
6570,70,2025-02-01,23637,3285,26922
6571,71,2025-02-01,25541,1657,27198
6572,72,2025-02-01,19174,3168,22342
6573,73,2025-02-01,38013,867,38880
6574,74,2025-02-01,23636,680,24316
6575,75,2025-02-01,25681,4170,29851
6576,76,2025-02-01,14950,2612,17562
6577,77,2025-02-01,12370,-3760,8610
6578,78,2025-02-01,26960,4763,31723
6579,79,2025-02-01,40976,1207,42183
6580,80,2025-02-01,47634,4239,51873
6581,81,2025-02-01,38272,136,38408
6582,82,2025-02-01,20473,1692,22165
6583,83,2025-02-01,15958,346,16304
6584,84,2025-02-01,11685,1616,13301
6585,85,2025-02-01,17715,4686,22401
6586,86,2025-02-01,33684,3223,36907
6587,87,2025-02-01,20260,2486,22746
6588,88,2025-02-01,26277,2001,28278
6589,89,2025-02-01,29961,469,30430
6590,90,2025-02-01,15805,3025,18830
6591,91,2025-02-01,20624,2205,22829
6592,92,2025-02-01,23269,904,24173
6593,93,2025-02-01,19263,90,19353
6594,94,2025-02-01,26291,4395,30686
6595,95,2025-02-01,29835,4913,34748
6596,96,2025-02-01,45781,376,46157
6597,97,2025-02-01,27092,1478,28570
6598,98,2025-02-01,17648,1387,19035
6599,99,2025-02-01,31098,1582,32680
6600,100,2025-02-01,38267,3201,41468
6601,101,2025-02-01,18215,4021,22236
6602,102,2025-02-01,21155,2121,23276
6603,103,2025-02-01,41670,1492,43162
6604,104,2025-02-01,40721,1702,42423
6605,105,2025-02-01,42536,3598,46134
6606,106,2025-02-01,24090,1763,25853
6607,107,2025-02-01,38535,4032,42567
6608,108,2025-02-01,49080,2693,51773
6609,109,2025-02-01,40884,1195,42079
6610,110,2025-02-01,12425,3887,16312
6611,111,2025-02-01,49720,3168,52888
6612,112,2025-02-01,46214,4966,51180
6613,113,2025-02-01,29942,3286,33228
6614,114,2025-02-01,43263,1401,44664
6615,115,2025-02-01,15082,4147,19229
6616,116,2025-02-01,19521,2335,21856
6617,117,2025-02-01,38949,667,39616
6618,118,2025-02-01,41376,2484,43860
6619,119,2025-02-01,39243,185,39428
6620,120,2025-02-01,25806,2626,28432
6621,121,2025-02-01,11913,4699,16612
6622,122,2025-02-01,46690,4464,51154
6623,123,2025-02-01,24616,741,25357
6624,124,2025-02-01,17055,582,17637
6625,125,2025-02-01,31222,2,31224
6626,126,2025-02-01,34470,391,34861
6627,127,2025-02-01,20839,4648,25487
6628,128,2025-02-01,46296,4550,50846
6629,129,2025-02-01,41585,3657,45242
6630,130,2025-02-01,20356,623,20979
6631,131,2025-02-01,14878,3501,18379
6632,132,2025-02-01,44036,4626,48662
6633,133,2025-02-01,40138,2506,42644
6634,134,2025-02-01,12778,2930,15708
6635,135,2025-02-01,28774,2667,31441
6636,136,2025-02-01,28204,1408,29612
6637,137,2025-02-01,37159,341,37500
6638,138,2025-02-01,29217,1783,31000
6639,139,2025-02-01,33728,2484,36212
6640,140,2025-02-01,34837,4766,39603
6641,141,2025-02-01,38249,4320,42569
6642,142,2025-02-01,45704,4367,50071
6643,143,2025-02-01,41285,2342,43627
6644,144,2025-02-01,26754,4820,31574
6645,145,2025-02-01,21854,1294,23148
6646,146,2025-02-01,15735,2468,18203
6647,147,2025-02-01,18799,3593,22392
6648,148,2025-02-01,43899,-4855,39044
6649,149,2025-02-01,44731,1500,46231
6650,150,2025-02-01,24519,274,24793
6651,151,2025-02-01,18408,606,19014
6652,152,2025-02-01,37103,1837,38940
6653,153,2025-02-01,40152,441,40593
6654,154,2025-02-01,28225,2370,30595
6655,155,2025-02-01,32577,3503,36080
6656,156,2025-02-01,18489,1159,19648
6657,157,2025-02-01,42592,976,43568
6658,158,2025-02-01,31003,778,31781
6659,159,2025-02-01,46339,1193,47532
6660,160,2025-02-01,15734,34,15768
6661,161,2025-02-01,34277,2558,36835
6662,162,2025-02-01,17250,1924,19174
6663,163,2025-02-01,33451,299,33750
6664,164,2025-02-01,29269,4439,33708
6665,165,2025-02-01,38059,4384,42443
6666,166,2025-02-01,27122,916,28038
6667,167,2025-02-01,33081,3643,36724
6668,168,2025-02-01,11126,2536,13662
6669,169,2025-02-01,48772,1652,50424
6670,170,2025-02-01,26986,540,27526
6671,171,2025-02-01,40901,1940,42841
6672,172,2025-02-01,15374,2242,17616
6673,173,2025-02-01,41019,2045,43064
6674,174,2025-02-01,31037,4042,35079
6675,175,2025-02-01,37084,4043,41127
6676,176,2025-02-01,27060,262,27322
6677,177,2025-02-01,25957,955,26912
6678,178,2025-02-01,29379,1024,30403
6679,179,2025-02-01,31478,4570,36048
6680,180,2025-02-01,21764,2986,24750
6681,181,2025-02-01,47089,2614,49703
6682,182,2025-02-01,12065,2215,14280
6683,183,2025-02-01,14111,2411,16522
6684,184,2025-02-01,49466,3107,52573
6685,185,2025-02-01,10921,2219,13140
6686,186,2025-02-01,37951,4719,42670
6687,187,2025-02-01,16677,-2760,13917
6688,188,2025-02-01,29950,4939,34889
6689,189,2025-02-01,0,2461,2461
6690,190,2025-02-01,40500,-358,40142
6691,191,2025-02-01,14287,67,14354
6692,192,2025-02-01,24781,3246,28027
6693,193,2025-02-01,47591,2090,49681
6694,194,2025-02-01,37468,2376,39844
6695,195,2025-02-01,17467,3835,21302
6696,196,2025-02-01,14776,3669,18445
6697,197,2025-02-01,45488,983,46471
6698,198,2025-02-01,23436,1726,25162
6699,199,2025-02-01,22286,1800,24086
6700,200,2025-02-01,40006,4151,44157
6701,201,2025-02-01,12809,3034,15843
6702,202,2025-02-01,22558,867,23425
6703,203,2025-02-01,17947,17,17964
6704,204,2025-02-01,40068,4801,44869
6705,205,2025-02-01,17834,163,17997
6706,206,2025-02-01,23184,4338,27522
6707,207,2025-02-01,21850,2640,24490
6708,208,2025-02-01,14945,2689,17634
6709,209,2025-02-01,37881,1720,39601
6710,210,2025-02-01,21462,4183,25645
6711,211,2025-02-01,12942,535,13477
6712,212,2025-02-01,17784,367,18151
6713,213,2025-02-01,42043,2558,44601
6714,214,2025-02-01,27332,1590,28922
6715,215,2025-02-01,17728,655,18383
6716,216,2025-02-01,43850,310,44160
6717,217,2025-02-01,38952,3589,42541
6718,218,2025-02-01,13712,1604,15316
6719,219,2025-02-01,30111,3404,33515
6720,220,2025-02-01,46441,3543,49984
6721,221,2025-02-01,16001,2412,18413
6722,222,2025-02-01,15827,1578,17405
6723,223,2025-02-01,49972,1198,51170
6724,224,2025-02-01,34964,4721,39685
6725,225,2025-02-01,48555,3166,51721
6726,226,2025-02-01,28138,4424,32562
6727,227,2025-02-01,17908,4396,22304
6728,228,2025-02-01,25118,535,25653
6729,229,2025-02-01,27102,150,27252
6730,230,2025-02-01,34328,2821,37149
6731,231,2025-02-01,32901,1091,33992
6732,232,2025-02-01,10781,87,10868
6733,233,2025-02-01,39290,1907,41197
6734,234,2025-02-01,16352,1788,18140
6735,235,2025-02-01,43696,684,44380
6736,236,2025-02-01,20680,1012,21692
6737,237,2025-02-01,42470,4792,47262
6738,238,2025-02-01,11236,521,11757
6739,239,2025-02-01,27480,4385,31865
6740,240,2025-02-01,14266,3903,18169
6741,241,2025-02-01,31167,1933,33100
6742,242,2025-02-01,21363,513,21876
6743,243,2025-02-01,10749,3033,13782
6744,244,2025-02-01,46135,2545,48680
6745,245,2025-02-01,31654,3595,35249
6746,246,2025-02-01,12722,294,13016
6747,247,2025-02-01,23268,1710,24978
6748,248,2025-02-01,27311,3382,30693
6749,249,2025-02-01,0,1952,1952
6750,250,2025-02-01,36216,4627,40843
6751,251,2025-02-01,42676,464,43140
6752,252,2025-02-01,39240,4816,44056
6753,253,2025-02-01,13564,626,14190
6754,254,2025-02-01,35830,1701,37531
6755,255,2025-02-01,22691,3117,25808
6756,256,2025-02-01,27578,4847,32425
6757,257,2025-02-01,34721,926,35647
6758,258,2025-02-01,19168,3684,22852
6759,259,2025-02-01,18423,329,18752
6760,260,2025-02-01,49798,892,50690
6761,261,2025-02-01,40762,3888,44650
6762,262,2025-02-01,28166,3671,31837
6763,263,2025-02-01,30538,3237,33775
6764,264,2025-02-01,10591,141,10732
6765,265,2025-02-01,28701,4850,33551
6766,266,2025-02-01,28084,1233,29317
6767,267,2025-02-01,18652,-3600,15052
6768,268,2025-02-01,19114,4549,23663
6769,269,2025-02-01,18480,1788,20268
6770,270,2025-02-01,46716,3191,49907
6771,271,2025-02-01,13609,3973,17582
6772,272,2025-02-01,30883,3125,34008
6773,273,2025-02-01,14627,3751,18378
6774,274,2025-02-01,20453,360,20813
6775,275,2025-02-01,31624,4362,35986
6776,276,2025-02-01,35667,3619,39286
6777,277,2025-02-01,44314,3788,48102
6778,278,2025-02-01,14363,2511,16874
6779,279,2025-02-01,47221,795,48016
6780,280,2025-02-01,45052,2204,47256
6781,281,2025-02-01,42153,878,43031
6782,282,2025-02-01,33370,3231,36601
6783,283,2025-02-01,29129,3911,33040
6784,284,2025-02-01,44821,3883,48704
6785,285,2025-02-01,34508,4327,38835
6786,286,2025-02-01,17783,-694,17089
6787,287,2025-02-01,42012,521,42533
6788,288,2025-02-01,0,2167,2167
6789,289,2025-02-01,33480,1393,34873
6790,290,2025-02-01,14966,2685,17651
6791,291,2025-02-01,17953,4941,22894
6792,292,2025-02-01,20225,2459,22684
6793,293,2025-02-01,20667,2997,23664
6794,294,2025-02-01,24265,1408,25673
6795,295,2025-02-01,39516,2492,42008
6796,296,2025-02-01,32406,597,33003
6797,297,2025-02-01,29165,1283,30448
6798,298,2025-02-01,41586,3710,45296
6799,299,2025-02-01,49539,268,49807
6800,300,2025-02-01,25630,3964,29594
6801,301,2025-02-01,24103,2957,27060
6802,302,2025-02-01,45165,4804,49969
6803,303,2025-02-01,31582,2295,33877
6804,304,2025-02-01,21292,4284,25576
6805,305,2025-02-01,26902,2852,29754
6806,306,2025-02-01,30714,2968,33682
6807,307,2025-02-01,36183,2927,39110
6808,308,2025-02-01,26321,470,26791
6809,309,2025-02-01,11814,-2838,8976
6810,310,2025-02-01,30364,5,30369
6811,311,2025-02-01,35959,3016,38975
6812,312,2025-02-01,22471,4765,27236
6813,313,2025-02-01,26903,4457,31360
6814,314,2025-02-01,24156,3746,27902
6815,315,2025-02-01,15253,2163,17416
6816,316,2025-02-01,36983,4833,41816
6817,317,2025-02-01,26288,2934,29222
6818,318,2025-02-01,12157,1377,13534
6819,319,2025-02-01,28948,143,29091
6820,320,2025-02-01,15936,3241,19177
6821,321,2025-02-01,38467,694,39161
6822,322,2025-02-01,39765,1573,41338
6823,323,2025-02-01,45731,2459,48190
6824,324,2025-02-01,17778,2161,19939
6825,325,2025-02-01,31093,2669,33762
6826,326,2025-02-01,41064,1117,42181
6827,327,2025-02-01,26193,1676,27869
6828,328,2025-02-01,41184,3092,44276
6829,329,2025-02-01,34994,128,35122
6830,330,2025-02-01,32520,3959,36479
6831,331,2025-02-01,27277,2057,29334
6832,332,2025-02-01,17633,3293,20926
6833,333,2025-02-01,33285,4721,38006
6834,334,2025-02-01,42104,3767,45871
6835,335,2025-02-01,10557,865,11422
6836,336,2025-02-01,30159,2281,32440
6837,337,2025-02-01,31692,4904,36596
6838,338,2025-02-01,21238,4695,25933
6839,339,2025-02-01,24098,3619,27717
6840,340,2025-02-01,31776,459,32235
6841,341,2025-02-01,45291,4283,49574
6842,342,2025-02-01,12161,3499,15660
6843,343,2025-02-01,12195,3914,16109
6844,344,2025-02-01,38685,306,38991
6845,345,2025-02-01,42409,4618,47027
6846,346,2025-02-01,46766,924,47690
6847,347,2025-02-01,25966,1595,27561
6848,348,2025-02-01,12768,472,13240
6849,349,2025-02-01,34287,2294,36581
6850,350,2025-02-01,13590,497,14087
6851,351,2025-02-01,30432,1345,31777
6852,352,2025-02-01,19746,287,20033
6853,353,2025-02-01,16524,819,17343
6854,354,2025-02-01,48140,2533,50673
6855,355,2025-02-01,26521,1315,27836
6856,356,2025-02-01,17240,1447,18687
6857,357,2025-02-01,39392,4521,43913
6858,358,2025-02-01,35676,1171,36847
6859,359,2025-02-01,23245,2822,26067
6860,360,2025-02-01,27070,1450,28520
6861,361,2025-02-01,11541,2826,14367
6862,362,2025-02-01,48465,4987,53452
6863,363,2025-02-01,49346,4471,53817
6864,364,2025-02-01,43656,4548,48204
6865,365,2025-02-01,32314,4201,36515
6866,366,2025-02-01,36909,384,37293
6867,367,2025-02-01,29297,3777,33074
6868,368,2025-02-01,35443,1333,36776
6869,369,2025-02-01,26277,2770,29047
6870,370,2025-02-01,40321,4250,44571
6871,371,2025-02-01,34444,1225,35669
6872,372,2025-02-01,0,3592,3592
6873,373,2025-02-01,33573,4919,38492
6874,374,2025-02-01,41961,3553,45514
6875,375,2025-02-01,29848,3970,33818
6876,376,2025-02-01,27763,4248,32011
6877,377,2025-02-01,10624,2465,13089
6878,378,2025-02-01,30862,2755,33617
6879,379,2025-02-01,11785,2833,14618
6880,380,2025-02-01,33234,102,33336
6881,381,2025-02-01,14974,4713,19687
6882,382,2025-02-01,15309,3714,19023
6883,383,2025-02-01,34192,2104,36296
6884,384,2025-02-01,48832,3281,52113
6885,385,2025-02-01,16787,2819,19606
6886,386,2025-02-01,37127,749,37876
6887,387,2025-02-01,16902,3469,20371
6888,388,2025-02-01,42804,4882,47686
6889,389,2025-02-01,24457,4280,28737
6890,390,2025-02-01,37136,1147,38283
6891,391,2025-02-01,47622,2187,49809
6892,392,2025-02-01,10717,1783,12500
6893,393,2025-02-01,40204,-4858,35346
6894,394,2025-02-01,11502,3920,15422
6895,395,2025-02-01,23903,2795,26698
6896,396,2025-02-01,22364,206,22570
6897,397,2025-02-01,26412,3640,30052
6898,398,2025-02-01,14378,1838,16216
6899,399,2025-02-01,33972,2037,36009
6900,400,2025-02-01,35108,-1415,33693
6901,401,2025-02-01,47041,4155,51196
6902,402,2025-02-01,39988,4808,44796
6903,403,2025-02-01,23871,3217,27088
6904,404,2025-02-01,42342,3216,45558
6905,405,2025-02-01,41779,4198,45977
6906,406,2025-02-01,38910,4646,43556
6907,407,2025-02-01,38819,4132,42951
6908,408,2025-02-01,38876,4110,42986
6909,409,2025-02-01,19925,3069,22994
6910,410,2025-02-01,40645,4047,44692
6911,411,2025-02-01,14778,522,15300
6912,412,2025-02-01,37441,1215,38656
6913,413,2025-02-01,13719,618,14337
6914,414,2025-02-01,24241,1162,25403
6915,415,2025-02-01,26212,1970,28182
6916,416,2025-02-01,39334,1189,40523
6917,417,2025-02-01,27334,1239,28573
6918,418,2025-02-01,48085,1514,49599
6919,419,2025-02-01,47973,4226,52199
6920,420,2025-02-01,13902,4815,18717
6921,421,2025-02-01,38006,564,38570
6922,422,2025-02-01,31486,160,31646
6923,423,2025-02-01,47734,3765,51499
6924,424,2025-02-01,15340,533,15873
6925,425,2025-02-01,0,1876,1876
6926,426,2025-02-01,38185,4232,42417
6927,427,2025-02-01,24791,3080,27871
6928,428,2025-02-01,28185,862,29047
6929,429,2025-02-01,45219,1025,46244
6930,430,2025-02-01,41719,124,41843
6931,431,2025-02-01,20250,4738,24988
6932,432,2025-02-01,25483,541,26024
6933,433,2025-02-01,39795,4049,43844
6934,434,2025-02-01,24385,2290,26675
6935,435,2025-02-01,47894,3175,51069
6936,436,2025-02-01,19952,2880,22832
6937,437,2025-02-01,45687,4754,50441
6938,438,2025-02-01,34394,4890,39284
6939,439,2025-02-01,35780,4883,40663
6940,440,2025-02-01,32150,-4816,27334
6941,441,2025-02-01,10608,956,11564
6942,442,2025-02-01,23028,4036,27064
6943,443,2025-02-01,26060,2411,28471
6944,444,2025-02-01,45553,450,46003
6945,445,2025-02-01,21536,1062,22598
6946,446,2025-02-01,44705,820,45525
6947,447,2025-02-01,11315,926,12241
6948,448,2025-02-01,49152,3373,52525
6949,449,2025-02-01,19407,1173,20580
6950,450,2025-02-01,34872,3830,38702
6951,451,2025-02-01,19392,1843,21235
6952,452,2025-02-01,13603,343,13946
6953,453,2025-02-01,39484,431,39915
6954,454,2025-02-01,25069,2325,27394
6955,455,2025-02-01,28872,3749,32621
6956,456,2025-02-01,24104,2914,27018
6957,457,2025-02-01,15112,2540,17652
6958,458,2025-02-01,40824,3124,43948
6959,459,2025-02-01,45535,1792,47327
6960,460,2025-02-01,10252,3308,13560
6961,461,2025-02-01,31789,3148,34937
6962,462,2025-02-01,31602,1136,32738
6963,463,2025-02-01,46533,4260,50793
6964,464,2025-02-01,37192,3945,41137
6965,465,2025-02-01,24760,2519,27279
6966,466,2025-02-01,37828,701,38529
6967,467,2025-02-01,32275,513,32788
6968,468,2025-02-01,33752,3161,36913
6969,469,2025-02-01,18456,1519,19975
6970,470,2025-02-01,34604,4835,39439
6971,471,2025-02-01,28355,654,29009
6972,472,2025-02-01,28919,904,29823
6973,473,2025-02-01,42537,-3862,38675
6974,474,2025-02-01,47786,2134,49920
6975,475,2025-02-01,24618,-4801,19817
6976,476,2025-02-01,46767,1546,48313
6977,477,2025-02-01,40672,472,41144
6978,478,2025-02-01,26364,2422,28786
6979,479,2025-02-01,18863,1644,20507
6980,480,2025-02-01,32174,1242,33416
6981,481,2025-02-01,46585,4718,51303
6982,482,2025-02-01,25138,53,25191
6983,483,2025-02-01,17807,289,18096
6984,484,2025-02-01,26303,1591,27894
6985,485,2025-02-01,48474,4218,52692
6986,486,2025-02-01,12692,507,13199
6987,487,2025-02-01,35410,29,35439
6988,488,2025-02-01,21832,3450,25282
6989,489,2025-02-01,12200,2436,14636
6990,490,2025-02-01,0,3075,3075
6991,491,2025-02-01,46024,2859,48883
6992,492,2025-02-01,15723,4104,19827
6993,493,2025-02-01,37167,3473,40640
6994,494,2025-02-01,0,3855,3855
6995,495,2025-02-01,47905,617,48522
6996,496,2025-02-01,31553,3399,34952
6997,497,2025-02-01,15555,4429,19984
6998,498,2025-02-01,26698,2007,28705
6999,499,2025-02-01,14151,4652,18803
7000,500,2025-02-01,22428,4745,27173
7001,1,2025-03-01,13958,2283,16241
7002,2,2025-03-01,35555,1182,36737
7003,3,2025-03-01,28152,-622,27530
7004,4,2025-03-01,42910,1856,44766
7005,5,2025-03-01,46963,2009,48972
7006,6,2025-03-01,11716,3729,15445
7007,7,2025-03-01,16001,1867,17868
7008,8,2025-03-01,29354,1743,31097
7009,9,2025-03-01,43652,4354,48006
7010,10,2025-03-01,20406,1778,22184
7011,11,2025-03-01,11065,1077,12142
7012,12,2025-03-01,10534,3016,13550
7013,13,2025-03-01,27319,4029,31348
7014,14,2025-03-01,0,467,467
7015,15,2025-03-01,16315,585,16900
7016,16,2025-03-01,25626,2172,27798
7017,17,2025-03-01,45721,1601,47322
7018,18,2025-03-01,17018,1523,18541
7019,19,2025-03-01,46870,1994,48864
7020,20,2025-03-01,29459,4131,33590
7021,21,2025-03-01,31484,910,32394
7022,22,2025-03-01,26274,366,26640
7023,23,2025-03-01,20356,1246,21602
7024,24,2025-03-01,47666,193,47859
7025,25,2025-03-01,34041,1752,35793
7026,26,2025-03-01,30120,4790,34910
7027,27,2025-03-01,41634,2243,43877
7028,28,2025-03-01,27922,2651,30573
7029,29,2025-03-01,24923,279,25202
7030,30,2025-03-01,11825,645,12470
7031,31,2025-03-01,19621,3224,22845
7032,32,2025-03-01,33801,3241,37042
7033,33,2025-03-01,28738,3572,32310
7034,34,2025-03-01,24789,1945,26734
7035,35,2025-03-01,49090,663,49753
7036,36,2025-03-01,21372,1789,23161
7037,37,2025-03-01,0,131,131
7038,38,2025-03-01,26801,2908,29709
7039,39,2025-03-01,39603,4710,44313
7040,40,2025-03-01,13113,4,13117
7041,41,2025-03-01,34298,373,34671
7042,42,2025-03-01,23431,1963,25394
7043,43,2025-03-01,37126,385,37511
7044,44,2025-03-01,29331,3067,32398
7045,45,2025-03-01,25824,906,26730
7046,46,2025-03-01,36337,2625,38962
7047,47,2025-03-01,36109,203,36312
7048,48,2025-03-01,45399,-4212,41187
7049,49,2025-03-01,39652,3565,43217
7050,50,2025-03-01,23310,3873,27183
7051,51,2025-03-01,0,4950,4950
7052,52,2025-03-01,0,-4592,-4592
7053,53,2025-03-01,36529,-3373,33156
7054,54,2025-03-01,44403,2163,46566
7055,55,2025-03-01,31252,2334,33586
7056,56,2025-03-01,15103,659,15762
7057,57,2025-03-01,35328,1974,37302
7058,58,2025-03-01,37158,1627,38785
7059,59,2025-03-01,46217,696,46913
7060,60,2025-03-01,33456,2260,35716
7061,61,2025-03-01,16568,2808,19376
7062,62,2025-03-01,10966,1811,12777
7063,63,2025-03-01,40840,1121,41961
7064,64,2025-03-01,16956,3271,20227
7065,65,2025-03-01,13382,4180,17562
7066,66,2025-03-01,18668,2061,20729
7067,67,2025-03-01,10846,2325,13171
7068,68,2025-03-01,27014,4627,31641
7069,69,2025-03-01,17195,2724,19919
7070,70,2025-03-01,22463,2012,24475
7071,71,2025-03-01,34466,2478,36944
7072,72,2025-03-01,26886,2495,29381
7073,73,2025-03-01,22291,3225,25516
7074,74,2025-03-01,25731,-1353,24378
7075,75,2025-03-01,40540,121,40661
7076,76,2025-03-01,44074,2395,46469
7077,77,2025-03-01,11736,2667,14403
7078,78,2025-03-01,14659,3424,18083
7079,79,2025-03-01,36724,1168,37892
7080,80,2025-03-01,21524,2772,24296
7081,81,2025-03-01,42577,1671,44248
7082,82,2025-03-01,36580,4930,41510
7083,83,2025-03-01,10637,3713,14350
7084,84,2025-03-01,47387,2194,49581
7085,85,2025-03-01,10210,1688,11898
7086,86,2025-03-01,27441,3911,31352
7087,87,2025-03-01,49918,4872,54790
7088,88,2025-03-01,11226,1380,12606
7089,89,2025-03-01,13003,1122,14125
7090,90,2025-03-01,19265,1144,20409
7091,91,2025-03-01,21504,2397,23901
7092,92,2025-03-01,33513,1012,34525
7093,93,2025-03-01,16722,1853,18575
7094,94,2025-03-01,35765,973,36738
7095,95,2025-03-01,32927,281,33208
7096,96,2025-03-01,0,-4996,-4996
7097,97,2025-03-01,40388,1057,41445
7098,98,2025-03-01,43099,3606,46705
7099,99,2025-03-01,38331,1591,39922
7100,100,2025-03-01,43025,3703,46728
7101,101,2025-03-01,13675,2304,15979
7102,102,2025-03-01,48746,7,48753
7103,103,2025-03-01,21640,3400,25040
7104,104,2025-03-01,11103,2338,13441
7105,105,2025-03-01,11917,945,12862
7106,106,2025-03-01,25834,839,26673
7107,107,2025-03-01,41150,301,41451
7108,108,2025-03-01,42005,2073,44078
7109,109,2025-03-01,17460,3878,21338
7110,110,2025-03-01,17816,731,18547
7111,111,2025-03-01,49084,3676,52760
7112,112,2025-03-01,39399,3373,42772
7113,113,2025-03-01,33690,3628,37318
7114,114,2025-03-01,18797,4536,23333
7115,115,2025-03-01,10620,3771,14391
7116,116,2025-03-01,24583,1943,26526
7117,117,2025-03-01,36120,2459,38579
7118,118,2025-03-01,30030,3369,33399
7119,119,2025-03-01,24140,2549,26689
7120,120,2025-03-01,42929,2072,45001
7121,121,2025-03-01,49346,1135,50481
7122,122,2025-03-01,32405,3815,36220
7123,123,2025-03-01,14165,2208,16373
7124,124,2025-03-01,43533,4909,48442
7125,125,2025-03-01,29138,2198,31336
7126,126,2025-03-01,46747,2863,49610
7127,127,2025-03-01,33226,4711,37937
7128,128,2025-03-01,11993,1458,13451
7129,129,2025-03-01,47690,2983,50673
7130,130,2025-03-01,33658,-1044,32614
7131,131,2025-03-01,40104,4393,44497
7132,132,2025-03-01,20809,1063,21872
7133,133,2025-03-01,36128,4685,40813
7134,134,2025-03-01,34122,231,34353
7135,135,2025-03-01,11614,548,12162
7136,136,2025-03-01,43189,1742,44931
7137,137,2025-03-01,25325,2224,27549
7138,138,2025-03-01,10109,2143,12252
7139,139,2025-03-01,25250,4765,30015
7140,140,2025-03-01,37153,3934,41087
7141,141,2025-03-01,24018,2276,26294
7142,142,2025-03-01,46880,3624,50504
7143,143,2025-03-01,34003,808,34811
7144,144,2025-03-01,35538,2031,37569
7145,145,2025-03-01,38914,936,39850
7146,146,2025-03-01,17128,2233,19361
7147,147,2025-03-01,19573,4739,24312
7148,148,2025-03-01,26691,4479,31170
7149,149,2025-03-01,41712,1042,42754
7150,150,2025-03-01,42485,1617,44102
7151,151,2025-03-01,23251,4182,27433
7152,152,2025-03-01,19487,3475,22962
7153,153,2025-03-01,31587,1624,33211
7154,154,2025-03-01,27167,4915,32082
7155,155,2025-03-01,11158,4035,15193
7156,156,2025-03-01,29044,4000,33044
7157,157,2025-03-01,36298,4115,40413
7158,158,2025-03-01,35237,1459,36696
7159,159,2025-03-01,15695,3083,18778
7160,160,2025-03-01,31692,2926,34618
7161,161,2025-03-01,34211,2958,37169
7162,162,2025-03-01,37479,653,38132
7163,163,2025-03-01,13261,3004,16265
7164,164,2025-03-01,14047,4779,18826
7165,165,2025-03-01,23212,2913,26125
7166,166,2025-03-01,46364,-1238,45126
7167,167,2025-03-01,20642,4656,25298
7168,168,2025-03-01,14190,1778,15968
7169,169,2025-03-01,12492,1449,13941
7170,170,2025-03-01,42174,1896,44070
7171,171,2025-03-01,48189,3495,51684
7172,172,2025-03-01,39721,4492,44213
7173,173,2025-03-01,43911,2584,46495
7174,174,2025-03-01,49096,3246,52342
7175,175,2025-03-01,25626,3118,28744
7176,176,2025-03-01,24194,2259,26453
7177,177,2025-03-01,41137,653,41790
7178,178,2025-03-01,15641,1668,17309
7179,179,2025-03-01,27729,746,28475
7180,180,2025-03-01,14560,309,14869
7181,181,2025-03-01,23845,4581,28426
7182,182,2025-03-01,16734,135,16869
7183,183,2025-03-01,20313,4010,24323
7184,184,2025-03-01,39574,3862,43436
7185,185,2025-03-01,14662,4110,18772
7186,186,2025-03-01,44779,132,44911
7187,187,2025-03-01,38786,2559,41345
7188,188,2025-03-01,36843,1760,38603
7189,189,2025-03-01,20309,3693,24002
7190,190,2025-03-01,40352,496,40848
7191,191,2025-03-01,40471,1618,42089
7192,192,2025-03-01,0,1486,1486
7193,193,2025-03-01,21864,3000,24864
7194,194,2025-03-01,47878,2091,49969
7195,195,2025-03-01,13311,1314,14625
7196,196,2025-03-01,10539,1509,12048
7197,197,2025-03-01,38827,4883,43710
7198,198,2025-03-01,42259,298,42557
7199,199,2025-03-01,31036,1039,32075
7200,200,2025-03-01,37593,3804,41397
7201,201,2025-03-01,13795,2518,16313
7202,202,2025-03-01,13741,401,14142
7203,203,2025-03-01,21210,448,21658
7204,204,2025-03-01,14918,3227,18145
7205,205,2025-03-01,35611,4073,39684
7206,206,2025-03-01,16123,88,16211
7207,207,2025-03-01,0,3408,3408
7208,208,2025-03-01,26240,1291,27531
7209,209,2025-03-01,12623,4582,17205
7210,210,2025-03-01,33176,2591,35767
7211,211,2025-03-01,38055,2635,40690
7212,212,2025-03-01,39689,4888,44577
7213,213,2025-03-01,30057,2287,32344
7214,214,2025-03-01,22305,2041,24346
7215,215,2025-03-01,26282,4208,30490
7216,216,2025-03-01,47192,4334,51526
7217,217,2025-03-01,34729,4668,39397
7218,218,2025-03-01,41499,1201,42700
7219,219,2025-03-01,35767,2914,38681
7220,220,2025-03-01,31998,3985,35983
7221,221,2025-03-01,30886,2954,33840
7222,222,2025-03-01,15186,2842,18028
7223,223,2025-03-01,23296,3228,26524
7224,224,2025-03-01,33996,208,34204
7225,225,2025-03-01,45592,1312,46904
7226,226,2025-03-01,18224,2059,20283
7227,227,2025-03-01,23108,2883,25991
7228,228,2025-03-01,28395,2276,30671
7229,229,2025-03-01,15935,1426,17361
7230,230,2025-03-01,43795,573,44368
7231,231,2025-03-01,27286,2231,29517
7232,232,2025-03-01,44255,3495,47750
7233,233,2025-03-01,27777,4564,32341
7234,234,2025-03-01,46039,3424,49463
7235,235,2025-03-01,26003,4235,30238
7236,236,2025-03-01,14529,4297,18826
7237,237,2025-03-01,13173,2159,15332
7238,238,2025-03-01,17463,1247,18710
7239,239,2025-03-01,49667,584,50251
7240,240,2025-03-01,44899,1205,46104
7241,241,2025-03-01,27977,4044,32021
7242,242,2025-03-01,31412,3083,34495
7243,243,2025-03-01,10510,4980,15490
7244,244,2025-03-01,18279,2690,20969
7245,245,2025-03-01,44942,2999,47941
7246,246,2025-03-01,21091,2284,23375
7247,247,2025-03-01,34103,2810,36913
7248,248,2025-03-01,15943,4941,20884
7249,249,2025-03-01,35172,-2758,32414
7250,250,2025-03-01,21936,1159,23095
7251,251,2025-03-01,49732,2228,51960
7252,252,2025-03-01,43578,3988,47566
7253,253,2025-03-01,17668,2874,20542
7254,254,2025-03-01,32051,2246,34297
7255,255,2025-03-01,35120,1917,37037
7256,256,2025-03-01,33791,2086,35877
7257,257,2025-03-01,25863,1829,27692
7258,258,2025-03-01,32325,1190,33515
7259,259,2025-03-01,33826,1588,35414
7260,260,2025-03-01,43374,1515,44889
7261,261,2025-03-01,45720,4081,49801
7262,262,2025-03-01,12404,2501,14905
7263,263,2025-03-01,45265,3191,48456
7264,264,2025-03-01,0,4845,4845
7265,265,2025-03-01,48767,1326,50093
7266,266,2025-03-01,29906,645,30551
7267,267,2025-03-01,47038,2134,49172
7268,268,2025-03-01,15348,1889,17237
7269,269,2025-03-01,29269,1124,30393
7270,270,2025-03-01,18685,1150,19835
7271,271,2025-03-01,36812,2578,39390
7272,272,2025-03-01,33626,3613,37239
7273,273,2025-03-01,29783,3689,33472
7274,274,2025-03-01,11946,2001,13947
7275,275,2025-03-01,27045,2634,29679
7276,276,2025-03-01,26296,4487,30783
7277,277,2025-03-01,48083,264,48347
7278,278,2025-03-01,24446,446,24892
7279,279,2025-03-01,45054,4001,49055
7280,280,2025-03-01,24044,2181,26225
7281,281,2025-03-01,28330,2334,30664
7282,282,2025-03-01,27185,2458,29643
7283,283,2025-03-01,17911,2648,20559
7284,284,2025-03-01,37848,2757,40605
7285,285,2025-03-01,24541,3406,27947
7286,286,2025-03-01,30852,4677,35529
7287,287,2025-03-01,39226,4658,43884
7288,288,2025-03-01,23348,3773,27121
7289,289,2025-03-01,48226,3589,51815
7290,290,2025-03-01,49098,393,49491
7291,291,2025-03-01,47549,273,47822
7292,292,2025-03-01,10314,1887,12201
7293,293,2025-03-01,27712,1945,29657
7294,294,2025-03-01,17836,2144,19980
7295,295,2025-03-01,48672,120,48792
7296,296,2025-03-01,23556,107,23663
7297,297,2025-03-01,29331,4857,34188
7298,298,2025-03-01,43176,938,44114
7299,299,2025-03-01,34321,998,35319
7300,300,2025-03-01,35672,2719,38391
7301,301,2025-03-01,46124,-77,46047
7302,302,2025-03-01,26297,3443,29740
7303,303,2025-03-01,15015,1159,16174
7304,304,2025-03-01,30011,1934,31945
7305,305,2025-03-01,14358,3595,17953
7306,306,2025-03-01,36657,1572,38229
7307,307,2025-03-01,13063,4299,17362
7308,308,2025-03-01,19898,3542,23440
7309,309,2025-03-01,25580,1802,27382
7310,310,2025-03-01,33158,728,33886
7311,311,2025-03-01,38825,3611,42436
7312,312,2025-03-01,39661,3825,43486
7313,313,2025-03-01,22780,2328,25108
7314,314,2025-03-01,42689,2332,45021
7315,315,2025-03-01,14372,4450,18822
7316,316,2025-03-01,24887,1627,26514
7317,317,2025-03-01,29549,2203,31752
7318,318,2025-03-01,11735,1428,13163
7319,319,2025-03-01,25218,2031,27249
7320,320,2025-03-01,33551,-1708,31843
7321,321,2025-03-01,30801,3036,33837
7322,322,2025-03-01,34719,3016,37735
7323,323,2025-03-01,46556,4107,50663
7324,324,2025-03-01,15068,196,15264
7325,325,2025-03-01,18751,4892,23643
7326,326,2025-03-01,31689,3598,35287
7327,327,2025-03-01,0,579,579
7328,328,2025-03-01,34814,460,35274
7329,329,2025-03-01,20372,1875,22247
7330,330,2025-03-01,16845,106,16951
7331,331,2025-03-01,33880,2521,36401
7332,332,2025-03-01,23560,2517,26077
7333,333,2025-03-01,41923,778,42701
7334,334,2025-03-01,15490,4126,19616
7335,335,2025-03-01,44198,1964,46162
7336,336,2025-03-01,17635,919,18554
7337,337,2025-03-01,45413,3851,49264
7338,338,2025-03-01,18132,2743,20875
7339,339,2025-03-01,47196,3119,50315
7340,340,2025-03-01,27370,1020,28390
7341,341,2025-03-01,17061,957,18018
7342,342,2025-03-01,21920,1619,23539
7343,343,2025-03-01,16797,532,17329
7344,344,2025-03-01,26386,6,26392
7345,345,2025-03-01,29717,2186,31903
7346,346,2025-03-01,13767,3476,17243
7347,347,2025-03-01,23863,3581,27444
7348,348,2025-03-01,0,542,542
7349,349,2025-03-01,44623,507,45130
7350,350,2025-03-01,43580,4768,48348
7351,351,2025-03-01,19683,4082,23765
7352,352,2025-03-01,41330,2815,44145
7353,353,2025-03-01,25904,3105,29009
7354,354,2025-03-01,0,2887,2887
7355,355,2025-03-01,38741,773,39514
7356,356,2025-03-01,14787,3347,18134
7357,357,2025-03-01,28849,939,29788
7358,358,2025-03-01,13641,3564,17205
7359,359,2025-03-01,27708,2414,30122
7360,360,2025-03-01,17880,579,18459
7361,361,2025-03-01,30898,926,31824
7362,362,2025-03-01,27956,1119,29075
7363,363,2025-03-01,49424,252,49676
7364,364,2025-03-01,18120,1076,19196
7365,365,2025-03-01,43168,529,43697
7366,366,2025-03-01,27831,1401,29232
7367,367,2025-03-01,24757,2504,27261
7368,368,2025-03-01,23540,3683,27223
7369,369,2025-03-01,16205,381,16586
7370,370,2025-03-01,19684,4280,23964
7371,371,2025-03-01,36000,4637,40637
7372,372,2025-03-01,33774,1207,34981
7373,373,2025-03-01,49839,1754,51593
7374,374,2025-03-01,43984,4236,48220
7375,375,2025-03-01,13219,4824,18043
7376,376,2025-03-01,19917,1869,21786
7377,377,2025-03-01,38263,501,38764
7378,378,2025-03-01,28210,4504,32714
7379,379,2025-03-01,29504,3575,33079
7380,380,2025-03-01,27209,1256,28465
7381,381,2025-03-01,18603,1326,19929
7382,382,2025-03-01,40833,1577,42410
7383,383,2025-03-01,49079,284,49363
7384,384,2025-03-01,13999,1029,15028
7385,385,2025-03-01,16884,4352,21236
7386,386,2025-03-01,45975,2810,48785
7387,387,2025-03-01,26750,2277,29027
7388,388,2025-03-01,28392,2892,31284
7389,389,2025-03-01,14475,761,15236
7390,390,2025-03-01,16763,3755,20518
7391,391,2025-03-01,41656,1918,43574
7392,392,2025-03-01,46031,838,46869
7393,393,2025-03-01,42134,2683,44817
7394,394,2025-03-01,38162,1092,39254
7395,395,2025-03-01,13369,1560,14929
7396,396,2025-03-01,27552,2063,29615
7397,397,2025-03-01,39590,1064,40654
7398,398,2025-03-01,34622,4915,39537
7399,399,2025-03-01,24474,1434,25908
7400,400,2025-03-01,39112,1587,40699
7401,401,2025-03-01,22695,3764,26459
7402,402,2025-03-01,11211,1188,12399
7403,403,2025-03-01,30252,1756,32008
7404,404,2025-03-01,21513,276,21789
7405,405,2025-03-01,33886,4166,38052
7406,406,2025-03-01,21387,4469,25856
7407,407,2025-03-01,33491,1244,34735
7408,408,2025-03-01,30558,2153,32711
7409,409,2025-03-01,14902,2446,17348
7410,410,2025-03-01,25436,3415,28851
7411,411,2025-03-01,24078,3402,27480
7412,412,2025-03-01,47472,1952,49424
7413,413,2025-03-01,14950,2104,17054
7414,414,2025-03-01,15951,1256,17207
7415,415,2025-03-01,28974,2369,31343
7416,416,2025-03-01,12929,4118,17047
7417,417,2025-03-01,27683,1222,28905
7418,418,2025-03-01,27338,3356,30694
7419,419,2025-03-01,22021,1228,23249
7420,420,2025-03-01,27434,2962,30396
7421,421,2025-03-01,27215,3112,30327
7422,422,2025-03-01,35026,3473,38499
7423,423,2025-03-01,41239,3366,44605
7424,424,2025-03-01,34952,3188,38140
7425,425,2025-03-01,18915,555,19470
7426,426,2025-03-01,34120,689,34809
7427,427,2025-03-01,37335,3662,40997
7428,428,2025-03-01,19014,3204,22218
7429,429,2025-03-01,13001,1726,14727
7430,430,2025-03-01,33306,300,33606
7431,431,2025-03-01,16532,1972,18504
7432,432,2025-03-01,45459,855,46314
7433,433,2025-03-01,14759,849,15608
7434,434,2025-03-01,32580,1494,34074
7435,435,2025-03-01,34218,2508,36726
7436,436,2025-03-01,43325,2803,46128
7437,437,2025-03-01,39002,1498,40500
7438,438,2025-03-01,29576,-989,28587
7439,439,2025-03-01,41740,3229,44969
7440,440,2025-03-01,27024,2539,29563
7441,441,2025-03-01,34566,4944,39510
7442,442,2025-03-01,11396,2966,14362
7443,443,2025-03-01,33030,4378,37408
7444,444,2025-03-01,0,4238,4238
7445,445,2025-03-01,34613,295,34908
7446,446,2025-03-01,43637,3791,47428
7447,447,2025-03-01,25892,2,25894
7448,448,2025-03-01,46094,244,46338
7449,449,2025-03-01,48296,1735,50031
7450,450,2025-03-01,34823,1265,36088
7451,451,2025-03-01,13507,3772,17279
7452,452,2025-03-01,32788,3847,36635
7453,453,2025-03-01,10912,2780,13692
7454,454,2025-03-01,22701,1351,24052
7455,455,2025-03-01,26670,2134,28804
7456,456,2025-03-01,31388,68,31456
7457,457,2025-03-01,14947,1710,16657
7458,458,2025-03-01,17169,3077,20246
7459,459,2025-03-01,46141,11,46152
7460,460,2025-03-01,14564,571,15135
7461,461,2025-03-01,35288,4392,39680
7462,462,2025-03-01,25323,1789,27112
7463,463,2025-03-01,49234,1323,50557
7464,464,2025-03-01,10811,3255,14066
7465,465,2025-03-01,24966,254,25220
7466,466,2025-03-01,17716,4220,21936
7467,467,2025-03-01,36054,3313,39367
7468,468,2025-03-01,20873,112,20985
7469,469,2025-03-01,26579,1420,27999
7470,470,2025-03-01,26577,3009,29586
7471,471,2025-03-01,32383,3298,35681
7472,472,2025-03-01,0,4213,4213
7473,473,2025-03-01,47967,2477,50444
7474,474,2025-03-01,45939,1088,47027
7475,475,2025-03-01,14709,1968,16677
7476,476,2025-03-01,12643,2799,15442
7477,477,2025-03-01,21710,751,22461
7478,478,2025-03-01,13147,3192,16339
7479,479,2025-03-01,24598,1681,26279
7480,480,2025-03-01,33186,3869,37055
7481,481,2025-03-01,26589,2399,28988
7482,482,2025-03-01,41793,1495,43288
7483,483,2025-03-01,16299,4167,20466
7484,484,2025-03-01,40120,-2614,37506
7485,485,2025-03-01,30521,4543,35064
7486,486,2025-03-01,25792,-2203,23589
7487,487,2025-03-01,31566,3393,34959
7488,488,2025-03-01,49303,1880,51183
7489,489,2025-03-01,32039,3342,35381
7490,490,2025-03-01,34357,2151,36508
7491,491,2025-03-01,25518,4200,29718
7492,492,2025-03-01,36524,42,36566
7493,493,2025-03-01,34306,3131,37437
7494,494,2025-03-01,20204,753,20957
7495,495,2025-03-01,33981,-1392,32589
7496,496,2025-03-01,0,4780,4780
7497,497,2025-03-01,21559,7,21566
7498,498,2025-03-01,39725,2802,42527
7499,499,2025-03-01,45608,3521,49129
7500,500,2025-03-01,33928,868,34796
7501,1,2025-04-01,11345,1456,12801
7502,2,2025-04-01,37435,837,38272
7503,3,2025-04-01,40617,3235,43852
7504,4,2025-04-01,0,832,832
7505,5,2025-04-01,25281,358,25639
7506,6,2025-04-01,45118,-966,44152
7507,7,2025-04-01,38079,4263,42342
7508,8,2025-04-01,12464,1280,13744
7509,9,2025-04-01,19770,2353,22123
7510,10,2025-04-01,25520,4919,30439
7511,11,2025-04-01,33808,395,34203
7512,12,2025-04-01,34216,1269,35485
7513,13,2025-04-01,49662,2046,51708
7514,14,2025-04-01,43658,2692,46350
7515,15,2025-04-01,13105,602,13707
7516,16,2025-04-01,49058,1344,50402
7517,17,2025-04-01,47250,3031,50281
7518,18,2025-04-01,24314,4534,28848
7519,19,2025-04-01,39596,3205,42801
7520,20,2025-04-01,33492,1760,35252
7521,21,2025-04-01,31308,3166,34474
7522,22,2025-04-01,29486,380,29866
7523,23,2025-04-01,30213,3924,34137
7524,24,2025-04-01,38874,3064,41938
7525,25,2025-04-01,35764,4019,39783
7526,26,2025-04-01,34098,159,34257
7527,27,2025-04-01,15035,3003,18038
7528,28,2025-04-01,25108,3977,29085
7529,29,2025-04-01,31231,-140,31091
7530,30,2025-04-01,18601,3690,22291
7531,31,2025-04-01,48559,2969,51528
7532,32,2025-04-01,18023,4228,22251
7533,33,2025-04-01,41916,2517,44433
7534,34,2025-04-01,47071,286,47357
7535,35,2025-04-01,18983,1405,20388
7536,36,2025-04-01,32604,3942,36546
7537,37,2025-04-01,44585,-3649,40936
7538,38,2025-04-01,20305,4005,24310
7539,39,2025-04-01,28957,2728,31685
7540,40,2025-04-01,20784,3124,23908
7541,41,2025-04-01,49239,165,49404
7542,42,2025-04-01,20610,1061,21671
7543,43,2025-04-01,19017,1657,20674
7544,44,2025-04-01,27453,3545,30998
7545,45,2025-04-01,34811,2675,37486
7546,46,2025-04-01,24845,4543,29388
7547,47,2025-04-01,35225,1100,36325
7548,48,2025-04-01,39585,3412,42997
7549,49,2025-04-01,37367,4247,41614
7550,50,2025-04-01,13564,2478,16042
7551,51,2025-04-01,23146,-2908,20238
7552,52,2025-04-01,32761,4668,37429
7553,53,2025-04-01,13117,2190,15307
7554,54,2025-04-01,39025,1705,40730
7555,55,2025-04-01,39833,4913,44746
7556,56,2025-04-01,15364,1419,16783
7557,57,2025-04-01,16807,1242,18049
7558,58,2025-04-01,12027,1103,13130
7559,59,2025-04-01,24749,38,24787
7560,60,2025-04-01,19332,4782,24114
7561,61,2025-04-01,33233,1275,34508
7562,62,2025-04-01,29598,786,30384
7563,63,2025-04-01,18637,3142,21779
7564,64,2025-04-01,36157,4574,40731
7565,65,2025-04-01,32018,1865,33883
7566,66,2025-04-01,25158,531,25689
7567,67,2025-04-01,19992,2118,22110
7568,68,2025-04-01,26394,4033,30427
7569,69,2025-04-01,26104,2700,28804
7570,70,2025-04-01,15668,18,15686
7571,71,2025-04-01,17755,443,18198
7572,72,2025-04-01,24472,2007,26479
7573,73,2025-04-01,44941,3191,48132
7574,74,2025-04-01,46987,1009,47996
7575,75,2025-04-01,18970,1121,20091
7576,76,2025-04-01,35068,2875,37943
7577,77,2025-04-01,25477,2601,28078
7578,78,2025-04-01,48550,1307,49857
7579,79,2025-04-01,47303,4575,51878
7580,80,2025-04-01,17760,3094,20854
7581,81,2025-04-01,37533,4729,42262
7582,82,2025-04-01,47350,4153,51503
7583,83,2025-04-01,21488,1670,23158
7584,84,2025-04-01,28984,1820,30804
7585,85,2025-04-01,26915,2792,29707
7586,86,2025-04-01,45326,1201,46527
7587,87,2025-04-01,11468,-623,10845
7588,88,2025-04-01,36465,733,37198
7589,89,2025-04-01,17040,3833,20873
7590,90,2025-04-01,23399,2029,25428
7591,91,2025-04-01,20169,-276,19893
7592,92,2025-04-01,19930,4910,24840
7593,93,2025-04-01,28512,1697,30209
7594,94,2025-04-01,35292,449,35741
7595,95,2025-04-01,34672,4622,39294
7596,96,2025-04-01,33867,1080,34947
7597,97,2025-04-01,38674,2753,41427
7598,98,2025-04-01,35049,1939,36988
7599,99,2025-04-01,20636,-89,20547
7600,100,2025-04-01,25963,4210,30173
7601,101,2025-04-01,11703,2831,14534
7602,102,2025-04-01,23414,1413,24827
7603,103,2025-04-01,12155,3556,15711
7604,104,2025-04-01,35295,-2859,32436
7605,105,2025-04-01,16436,2225,18661
7606,106,2025-04-01,0,4976,4976
7607,107,2025-04-01,38141,618,38759
7608,108,2025-04-01,28656,1614,30270
7609,109,2025-04-01,40537,4864,45401
7610,110,2025-04-01,38779,4011,42790
7611,111,2025-04-01,21445,3184,24629
7612,112,2025-04-01,23783,605,24388
7613,113,2025-04-01,12129,2076,14205
7614,114,2025-04-01,46684,2110,48794
7615,115,2025-04-01,11261,2637,13898
7616,116,2025-04-01,45951,2339,48290
7617,117,2025-04-01,26885,3810,30695
7618,118,2025-04-01,15088,2666,17754
7619,119,2025-04-01,22199,1049,23248
7620,120,2025-04-01,47004,3031,50035
7621,121,2025-04-01,29498,1791,31289
7622,122,2025-04-01,35489,2736,38225
7623,123,2025-04-01,40527,1746,42273
7624,124,2025-04-01,36739,2812,39551
7625,125,2025-04-01,18415,2280,20695
7626,126,2025-04-01,43503,3541,47044
7627,127,2025-04-01,19953,935,20888
7628,128,2025-04-01,34530,308,34838
7629,129,2025-04-01,36207,4625,40832
7630,130,2025-04-01,19136,452,19588
7631,131,2025-04-01,15388,2247,17635
7632,132,2025-04-01,30347,4347,34694
7633,133,2025-04-01,24435,1089,25524
7634,134,2025-04-01,24624,553,25177
7635,135,2025-04-01,13082,4228,17310
7636,136,2025-04-01,32898,3430,36328
7637,137,2025-04-01,39988,1675,41663
7638,138,2025-04-01,20894,2305,23199
7639,139,2025-04-01,27114,3194,30308
7640,140,2025-04-01,27844,2409,30253
7641,141,2025-04-01,38432,4856,43288
7642,142,2025-04-01,46898,1210,48108
7643,143,2025-04-01,27965,4559,32524
7644,144,2025-04-01,15805,2281,18086
7645,145,2025-04-01,46868,3893,50761
7646,146,2025-04-01,44793,4261,49054
7647,147,2025-04-01,32752,2256,35008
7648,148,2025-04-01,16968,4830,21798
7649,149,2025-04-01,10016,453,10469
7650,150,2025-04-01,27932,4711,32643
7651,151,2025-04-01,24766,2343,27109
7652,152,2025-04-01,14004,3611,17615
7653,153,2025-04-01,11819,219,12038
7654,154,2025-04-01,25849,438,26287
7655,155,2025-04-01,46945,3305,50250
7656,156,2025-04-01,24852,2611,27463
7657,157,2025-04-01,27167,2084,29251
7658,158,2025-04-01,17624,2239,19863
7659,159,2025-04-01,42611,2284,44895
7660,160,2025-04-01,32257,1504,33761
7661,161,2025-04-01,35342,1285,36627
7662,162,2025-04-01,33612,2561,36173
7663,163,2025-04-01,23047,4108,27155
7664,164,2025-04-01,34236,1167,35403
7665,165,2025-04-01,11545,2807,14352
7666,166,2025-04-01,42433,-3350,39083
7667,167,2025-04-01,47697,445,48142
7668,168,2025-04-01,11021,1738,12759
7669,169,2025-04-01,31692,3444,35136
7670,170,2025-04-01,39405,4736,44141
7671,171,2025-04-01,10115,4715,14830
7672,172,2025-04-01,39377,1903,41280
7673,173,2025-04-01,44857,1258,46115
7674,174,2025-04-01,33565,1188,34753
7675,175,2025-04-01,46027,3710,49737
7676,176,2025-04-01,32045,143,32188
7677,177,2025-04-01,48383,391,48774
7678,178,2025-04-01,24577,2697,27274
7679,179,2025-04-01,20670,2835,23505
7680,180,2025-04-01,15149,1179,16328
7681,181,2025-04-01,39367,2208,41575
7682,182,2025-04-01,22431,4311,26742
7683,183,2025-04-01,17810,3235,21045
7684,184,2025-04-01,49459,2244,51703
7685,185,2025-04-01,12854,1484,14338
7686,186,2025-04-01,32078,4482,36560
7687,187,2025-04-01,16562,1006,17568
7688,188,2025-04-01,12050,4141,16191
7689,189,2025-04-01,45702,1276,46978
7690,190,2025-04-01,42815,2218,45033
7691,191,2025-04-01,36294,236,36530
7692,192,2025-04-01,20977,1813,22790
7693,193,2025-04-01,27374,2131,29505
7694,194,2025-04-01,23713,1167,24880
7695,195,2025-04-01,40609,363,40972
7696,196,2025-04-01,38351,2623,40974
7697,197,2025-04-01,47539,3091,50630
7698,198,2025-04-01,37385,4797,42182
7699,199,2025-04-01,14207,2607,16814
7700,200,2025-04-01,29773,3362,33135
7701,201,2025-04-01,17320,198,17518
7702,202,2025-04-01,44607,2740,47347
7703,203,2025-04-01,38135,2837,40972
7704,204,2025-04-01,31319,86,31405
7705,205,2025-04-01,43603,3814,47417
7706,206,2025-04-01,47652,4849,52501
7707,207,2025-04-01,45419,2857,48276
7708,208,2025-04-01,15009,1886,16895
7709,209,2025-04-01,19946,4702,24648
7710,210,2025-04-01,47998,-597,47401
7711,211,2025-04-01,28867,351,29218
7712,212,2025-04-01,31066,920,31986
7713,213,2025-04-01,42416,201,42617
7714,214,2025-04-01,32240,843,33083
7715,215,2025-04-01,25945,2180,28125
7716,216,2025-04-01,10157,954,11111
7717,217,2025-04-01,21060,2050,23110
7718,218,2025-04-01,41384,4648,46032
7719,219,2025-04-01,18885,1997,20882
7720,220,2025-04-01,26507,319,26826
7721,221,2025-04-01,21542,3319,24861
7722,222,2025-04-01,45785,2939,48724
7723,223,2025-04-01,30508,4154,34662
7724,224,2025-04-01,42231,4258,46489
7725,225,2025-04-01,47092,4822,51914
7726,226,2025-04-01,37003,1169,38172
7727,227,2025-04-01,43125,1154,44279
7728,228,2025-04-01,28085,-2142,25943
7729,229,2025-04-01,28532,4108,32640
7730,230,2025-04-01,18704,2302,21006
7731,231,2025-04-01,21030,1307,22337
7732,232,2025-04-01,15735,4557,20292
7733,233,2025-04-01,42668,158,42826
7734,234,2025-04-01,43625,2389,46014
7735,235,2025-04-01,10678,334,11012
7736,236,2025-04-01,20266,4120,24386
7737,237,2025-04-01,38006,1783,39789
7738,238,2025-04-01,17146,4213,21359
7739,239,2025-04-01,39928,1764,41692
7740,240,2025-04-01,23498,3906,27404
7741,241,2025-04-01,44495,3090,47585
7742,242,2025-04-01,10003,3798,13801
7743,243,2025-04-01,10261,2147,12408
7744,244,2025-04-01,34616,2995,37611
7745,245,2025-04-01,46168,3584,49752
7746,246,2025-04-01,24836,177,25013
7747,247,2025-04-01,39675,1247,40922
7748,248,2025-04-01,15680,2919,18599
7749,249,2025-04-01,28236,4475,32711
7750,250,2025-04-01,32117,3161,35278
7751,251,2025-04-01,10983,235,11218
7752,252,2025-04-01,31145,1700,32845
7753,253,2025-04-01,25217,37,25254
7754,254,2025-04-01,30617,2679,33296
7755,255,2025-04-01,21217,1837,23054
7756,256,2025-04-01,21348,1178,22526
7757,257,2025-04-01,46303,411,46714
7758,258,2025-04-01,32546,-3134,29412
7759,259,2025-04-01,33773,1827,35600
7760,260,2025-04-01,21457,710,22167
7761,261,2025-04-01,10616,2275,12891
7762,262,2025-04-01,24264,2942,27206
7763,263,2025-04-01,37491,1949,39440
7764,264,2025-04-01,38662,991,39653
7765,265,2025-04-01,31399,4723,36122
7766,266,2025-04-01,32057,4405,36462
7767,267,2025-04-01,13808,1860,15668
7768,268,2025-04-01,48590,38,48628
7769,269,2025-04-01,30934,1201,32135
7770,270,2025-04-01,39008,112,39120
7771,271,2025-04-01,17214,2041,19255
7772,272,2025-04-01,38695,137,38832
7773,273,2025-04-01,32135,2966,35101
7774,274,2025-04-01,45998,1479,47477
7775,275,2025-04-01,20745,3309,24054
7776,276,2025-04-01,19031,2674,21705
7777,277,2025-04-01,24382,2426,26808
7778,278,2025-04-01,0,2416,2416
7779,279,2025-04-01,34420,4125,38545
7780,280,2025-04-01,21535,2966,24501
7781,281,2025-04-01,25225,3228,28453
7782,282,2025-04-01,35440,739,36179
7783,283,2025-04-01,34435,3687,38122
7784,284,2025-04-01,32196,4838,37034
7785,285,2025-04-01,24800,305,25105
7786,286,2025-04-01,43250,630,43880
7787,287,2025-04-01,32102,4861,36963
7788,288,2025-04-01,19160,1163,20323
7789,289,2025-04-01,25551,2330,27881
7790,290,2025-04-01,49423,3953,53376
7791,291,2025-04-01,48184,2052,50236
7792,292,2025-04-01,14682,780,15462
7793,293,2025-04-01,16228,1514,17742
7794,294,2025-04-01,24319,1991,26310
7795,295,2025-04-01,49218,2274,51492
7796,296,2025-04-01,36125,1577,37702
7797,297,2025-04-01,39660,250,39910
7798,298,2025-04-01,10583,3174,13757
7799,299,2025-04-01,39249,628,39877
7800,300,2025-04-01,49750,1540,51290
7801,301,2025-04-01,25194,709,25903
7802,302,2025-04-01,13359,2296,15655
7803,303,2025-04-01,43613,4790,48403
7804,304,2025-04-01,37188,4799,41987
7805,305,2025-04-01,47382,2262,49644
7806,306,2025-04-01,43963,732,44695
7807,307,2025-04-01,34334,1141,35475
7808,308,2025-04-01,34493,4722,39215
7809,309,2025-04-01,19564,3952,23516
7810,310,2025-04-01,32285,3679,35964
7811,311,2025-04-01,35036,3403,38439
7812,312,2025-04-01,32319,546,32865
7813,313,2025-04-01,17943,602,18545
7814,314,2025-04-01,14756,456,15212
7815,315,2025-04-01,11906,901,12807
7816,316,2025-04-01,29064,2592,31656
7817,317,2025-04-01,19427,4378,23805
7818,318,2025-04-01,49962,278,50240
7819,319,2025-04-01,20520,3786,24306
7820,320,2025-04-01,44462,4333,48795
7821,321,2025-04-01,47809,395,48204
7822,322,2025-04-01,49221,4644,53865
7823,323,2025-04-01,23729,4808,28537
7824,324,2025-04-01,47592,3471,51063
7825,325,2025-04-01,30964,2310,33274
7826,326,2025-04-01,33229,2750,35979
7827,327,2025-04-01,18492,2466,20958
7828,328,2025-04-01,37187,3992,41179
7829,329,2025-04-01,25079,4531,29610
7830,330,2025-04-01,0,1359,1359
7831,331,2025-04-01,30968,479,31447
7832,332,2025-04-01,46821,4398,51219
7833,333,2025-04-01,0,1878,1878
7834,334,2025-04-01,32095,3926,36021
7835,335,2025-04-01,17591,832,18423
7836,336,2025-04-01,15971,2269,18240
7837,337,2025-04-01,11904,3442,15346
7838,338,2025-04-01,16890,569,17459
7839,339,2025-04-01,12930,3085,16015
7840,340,2025-04-01,20044,4983,25027
7841,341,2025-04-01,12289,1321,13610
7842,342,2025-04-01,22523,2879,25402
7843,343,2025-04-01,11927,1847,13774
7844,344,2025-04-01,10346,2440,12786
7845,345,2025-04-01,17117,1633,18750
7846,346,2025-04-01,40233,2625,42858
7847,347,2025-04-01,39189,3601,42790
7848,348,2025-04-01,46110,4548,50658
7849,349,2025-04-01,14149,3644,17793
7850,350,2025-04-01,11013,1488,12501
7851,351,2025-04-01,34269,2461,36730
7852,352,2025-04-01,22747,1113,23860
7853,353,2025-04-01,17928,3046,20974
7854,354,2025-04-01,38793,2027,40820
7855,355,2025-04-01,43483,3584,47067
7856,356,2025-04-01,37080,2029,39109
7857,357,2025-04-01,36320,445,36765
7858,358,2025-04-01,30990,4622,35612
7859,359,2025-04-01,27779,2390,30169
7860,360,2025-04-01,17443,1335,18778
7861,361,2025-04-01,30117,2253,32370
7862,362,2025-04-01,17351,115,17466
7863,363,2025-04-01,26113,4494,30607
7864,364,2025-04-01,19914,4266,24180
7865,365,2025-04-01,44171,3938,48109
7866,366,2025-04-01,17232,4030,21262
7867,367,2025-04-01,18026,2792,20818
7868,368,2025-04-01,20459,3245,23704
7869,369,2025-04-01,16220,3870,20090
7870,370,2025-04-01,48287,2145,50432
7871,371,2025-04-01,36037,669,36706
7872,372,2025-04-01,40128,4892,45020
7873,373,2025-04-01,23146,668,23814
7874,374,2025-04-01,43477,2197,45674
7875,375,2025-04-01,15339,4491,19830
7876,376,2025-04-01,30511,4115,34626
7877,377,2025-04-01,43945,1720,45665
7878,378,2025-04-01,47572,1473,49045
7879,379,2025-04-01,12378,-4385,7993
7880,380,2025-04-01,47454,203,47657
7881,381,2025-04-01,12774,155,12929
7882,382,2025-04-01,11612,4396,16008
7883,383,2025-04-01,33185,208,33393
7884,384,2025-04-01,43560,448,44008
7885,385,2025-04-01,27596,280,27876
7886,386,2025-04-01,38334,2923,41257
7887,387,2025-04-01,39326,4384,43710
7888,388,2025-04-01,36958,682,37640
7889,389,2025-04-01,48990,3982,52972
7890,390,2025-04-01,18457,1962,20419
7891,391,2025-04-01,30383,102,30485
7892,392,2025-04-01,20554,1254,21808
7893,393,2025-04-01,48582,3588,52170
7894,394,2025-04-01,11409,59,11468
7895,395,2025-04-01,19467,1849,21316
7896,396,2025-04-01,12956,1161,14117
7897,397,2025-04-01,27806,1236,29042
7898,398,2025-04-01,42453,195,42648
7899,399,2025-04-01,15661,4795,20456
7900,400,2025-04-01,39032,2292,41324
7901,401,2025-04-01,19194,4439,23633
7902,402,2025-04-01,22069,756,22825
7903,403,2025-04-01,17575,2693,20268
7904,404,2025-04-01,13100,2349,15449
7905,405,2025-04-01,32299,2673,34972
7906,406,2025-04-01,49814,2996,52810
7907,407,2025-04-01,40842,2582,43424
7908,408,2025-04-01,42991,4476,47467
7909,409,2025-04-01,33995,2399,36394
7910,410,2025-04-01,45391,1796,47187
7911,411,2025-04-01,15741,580,16321
7912,412,2025-04-01,19346,-4110,15236
7913,413,2025-04-01,18883,4142,23025
7914,414,2025-04-01,34431,362,34793
7915,415,2025-04-01,45243,3011,48254
7916,416,2025-04-01,42378,1352,43730
7917,417,2025-04-01,28890,-2769,26121
7918,418,2025-04-01,47506,2112,49618
7919,419,2025-04-01,12501,3300,15801
7920,420,2025-04-01,12954,2504,15458
7921,421,2025-04-01,26762,1170,27932
7922,422,2025-04-01,41299,4767,46066
7923,423,2025-04-01,26013,3245,29258
7924,424,2025-04-01,38210,675,38885
7925,425,2025-04-01,0,680,680
7926,426,2025-04-01,17699,1472,19171
7927,427,2025-04-01,34462,45,34507
7928,428,2025-04-01,32081,2765,34846
7929,429,2025-04-01,39401,3876,43277
7930,430,2025-04-01,44395,1378,45773
7931,431,2025-04-01,39413,4835,44248
7932,432,2025-04-01,22379,1222,23601
7933,433,2025-04-01,17189,900,18089
7934,434,2025-04-01,28873,3024,31897
7935,435,2025-04-01,31162,3626,34788
7936,436,2025-04-01,31122,1710,32832
7937,437,2025-04-01,19785,1993,21778
7938,438,2025-04-01,29954,3066,33020
7939,439,2025-04-01,33331,493,33824
7940,440,2025-04-01,49103,1351,50454
7941,441,2025-04-01,25817,4766,30583
7942,442,2025-04-01,27503,3838,31341
7943,443,2025-04-01,21864,4499,26363
7944,444,2025-04-01,32970,2664,35634
7945,445,2025-04-01,46378,4947,51325
7946,446,2025-04-01,38754,749,39503
7947,447,2025-04-01,28633,2056,30689
7948,448,2025-04-01,19218,3761,22979
7949,449,2025-04-01,21915,3310,25225
7950,450,2025-04-01,38787,2670,41457
7951,451,2025-04-01,31991,2260,34251
7952,452,2025-04-01,42058,195,42253
7953,453,2025-04-01,35408,3747,39155
7954,454,2025-04-01,27605,3053,30658
7955,455,2025-04-01,17113,3712,20825
7956,456,2025-04-01,31745,990,32735
7957,457,2025-04-01,35639,1730,37369
7958,458,2025-04-01,0,2629,2629
7959,459,2025-04-01,10554,3715,14269
7960,460,2025-04-01,35993,2180,38173
7961,461,2025-04-01,37904,4394,42298
7962,462,2025-04-01,47934,2070,50004
7963,463,2025-04-01,39272,763,40035
7964,464,2025-04-01,26667,4396,31063
7965,465,2025-04-01,36753,1976,38729
7966,466,2025-04-01,42830,199,43029
7967,467,2025-04-01,13911,42,13953
7968,468,2025-04-01,21093,3408,24501
7969,469,2025-04-01,25021,818,25839
7970,470,2025-04-01,44986,4981,49967
7971,471,2025-04-01,47057,4889,51946
7972,472,2025-04-01,49001,4893,53894
7973,473,2025-04-01,24358,4038,28396
7974,474,2025-04-01,26401,4550,30951
7975,475,2025-04-01,21928,2845,24773
7976,476,2025-04-01,0,2793,2793
7977,477,2025-04-01,42388,4881,47269
7978,478,2025-04-01,26748,3801,30549
7979,479,2025-04-01,23613,1859,25472
7980,480,2025-04-01,34635,443,35078
7981,481,2025-04-01,32292,2897,35189
7982,482,2025-04-01,34113,1676,35789
7983,483,2025-04-01,45017,689,45706
7984,484,2025-04-01,45653,1210,46863
7985,485,2025-04-01,14468,1062,15530
7986,486,2025-04-01,0,4162,4162
7987,487,2025-04-01,27500,4454,31954
7988,488,2025-04-01,11786,3930,15716
7989,489,2025-04-01,40915,3111,44026
7990,490,2025-04-01,35118,4935,40053
7991,491,2025-04-01,42061,20,42081
7992,492,2025-04-01,43668,2539,46207
7993,493,2025-04-01,49653,4683,54336
7994,494,2025-04-01,45080,282,45362
7995,495,2025-04-01,46272,1928,48200
7996,496,2025-04-01,44690,4879,49569
7997,497,2025-04-01,39922,3320,43242
7998,498,2025-04-01,15551,4020,19571
7999,499,2025-04-01,48103,946,49049
8000,500,2025-04-01,40487,1156,41643
8001,1,2025-05-01,31392,152,31544
8002,2,2025-05-01,25707,4684,30391
8003,3,2025-05-01,33456,2363,35819
8004,4,2025-05-01,37800,3536,41336
8005,5,2025-05-01,19724,3569,23293
8006,6,2025-05-01,49331,3866,53197
8007,7,2025-05-01,42934,4259,47193
8008,8,2025-05-01,40812,1255,42067
8009,9,2025-05-01,17468,1185,18653
8010,10,2025-05-01,13669,934,14603
8011,11,2025-05-01,44763,642,45405
8012,12,2025-05-01,43990,3753,47743
8013,13,2025-05-01,40296,3798,44094
8014,14,2025-05-01,16795,1323,18118
8015,15,2025-05-01,40167,689,40856
8016,16,2025-05-01,27430,3035,30465
8017,17,2025-05-01,36726,392,37118
8018,18,2025-05-01,29911,2360,32271
8019,19,2025-05-01,33043,4909,37952
8020,20,2025-05-01,25267,2281,27548
8021,21,2025-05-01,42930,1902,44832
8022,22,2025-05-01,27829,3647,31476
8023,23,2025-05-01,47477,2271,49748
8024,24,2025-05-01,34101,4940,39041
8025,25,2025-05-01,44817,1791,46608
8026,26,2025-05-01,16350,3813,20163
8027,27,2025-05-01,40207,554,40761
8028,28,2025-05-01,18867,358,19225
8029,29,2025-05-01,30269,3191,33460
8030,30,2025-05-01,31094,1446,32540
8031,31,2025-05-01,45229,1410,46639
8032,32,2025-05-01,26250,238,26488
8033,33,2025-05-01,32637,4244,36881
8034,34,2025-05-01,41829,466,42295
8035,35,2025-05-01,21483,2900,24383
8036,36,2025-05-01,34980,3320,38300
8037,37,2025-05-01,46016,1221,47237
8038,38,2025-05-01,47549,2851,50400
8039,39,2025-05-01,29081,3364,32445
8040,40,2025-05-01,20724,1801,22525
8041,41,2025-05-01,24868,4459,29327
8042,42,2025-05-01,43402,4136,47538
8043,43,2025-05-01,30420,97,30517
8044,44,2025-05-01,20568,3423,23991
8045,45,2025-05-01,39690,3624,43314
8046,46,2025-05-01,26450,4504,30954
8047,47,2025-05-01,11266,664,11930
8048,48,2025-05-01,30360,1451,31811
8049,49,2025-05-01,41341,3625,44966
8050,50,2025-05-01,28049,2780,30829
8051,51,2025-05-01,14425,3678,18103
8052,52,2025-05-01,19217,1743,20960
8053,53,2025-05-01,26073,1893,27966
8054,54,2025-05-01,32564,893,33457
8055,55,2025-05-01,35913,141,36054
8056,56,2025-05-01,29178,2250,31428
8057,57,2025-05-01,49736,563,50299
8058,58,2025-05-01,30332,692,31024
8059,59,2025-05-01,27119,815,27934
8060,60,2025-05-01,26264,4235,30499
8061,61,2025-05-01,19483,1898,21381
8062,62,2025-05-01,13287,3373,16660
8063,63,2025-05-01,21418,3306,24724
8064,64,2025-05-01,22097,3038,25135
8065,65,2025-05-01,23472,1804,25276
8066,66,2025-05-01,43567,1281,44848
8067,67,2025-05-01,41937,1702,43639
8068,68,2025-05-01,42557,1559,44116
8069,69,2025-05-01,25210,2831,28041
8070,70,2025-05-01,20506,1429,21935
8071,71,2025-05-01,37770,960,38730
8072,72,2025-05-01,22887,1339,24226
8073,73,2025-05-01,35204,1015,36219
8074,74,2025-05-01,45666,4972,50638
8075,75,2025-05-01,28125,4874,32999
8076,76,2025-05-01,40329,5000,45329
8077,77,2025-05-01,17219,1549,18768
8078,78,2025-05-01,42485,3574,46059
8079,79,2025-05-01,31272,1284,32556
8080,80,2025-05-01,39887,1796,41683
8081,81,2025-05-01,15382,1078,16460
8082,82,2025-05-01,39299,642,39941
8083,83,2025-05-01,47118,3013,50131
8084,84,2025-05-01,12002,401,12403
8085,85,2025-05-01,49561,565,50126
8086,86,2025-05-01,10659,273,10932
8087,87,2025-05-01,20134,-1597,18537
8088,88,2025-05-01,41931,2186,44117
8089,89,2025-05-01,27562,1145,28707
8090,90,2025-05-01,35422,1072,36494
8091,91,2025-05-01,42149,2079,44228
8092,92,2025-05-01,33723,1293,35016
8093,93,2025-05-01,29219,3671,32890
8094,94,2025-05-01,10097,1433,11530
8095,95,2025-05-01,19729,1365,21094
8096,96,2025-05-01,42521,4327,46848
8097,97,2025-05-01,49761,4206,53967
8098,98,2025-05-01,40504,3193,43697
8099,99,2025-05-01,33424,124,33548
8100,100,2025-05-01,0,696,696
8101,101,2025-05-01,42319,2926,45245
8102,102,2025-05-01,39730,3456,43186
8103,103,2025-05-01,34751,1683,36434
8104,104,2025-05-01,27377,-930,26447
8105,105,2025-05-01,21256,3721,24977
8106,106,2025-05-01,22135,1157,23292
8107,107,2025-05-01,15270,3229,18499
8108,108,2025-05-01,41830,3050,44880
8109,109,2025-05-01,46731,193,46924
8110,110,2025-05-01,17454,1817,19271
8111,111,2025-05-01,24076,687,24763
8112,112,2025-05-01,24833,4195,29028
8113,113,2025-05-01,46013,4161,50174
8114,114,2025-05-01,29114,4013,33127
8115,115,2025-05-01,25125,2409,27534
8116,116,2025-05-01,38784,1090,39874
8117,117,2025-05-01,26225,4368,30593
8118,118,2025-05-01,23154,4511,27665
8119,119,2025-05-01,13687,4550,18237
8120,120,2025-05-01,49161,1077,50238
8121,121,2025-05-01,28226,1169,29395
8122,122,2025-05-01,20232,682,20914
8123,123,2025-05-01,26481,4249,30730
8124,124,2025-05-01,39132,3335,42467
8125,125,2025-05-01,20498,1360,21858
8126,126,2025-05-01,40245,180,40425
8127,127,2025-05-01,29643,285,29928
8128,128,2025-05-01,14823,783,15606
8129,129,2025-05-01,27609,1530,29139
8130,130,2025-05-01,31104,4874,35978
8131,131,2025-05-01,11069,-1758,9311
8132,132,2025-05-01,38406,1018,39424
8133,133,2025-05-01,29735,893,30628
8134,134,2025-05-01,48039,2829,50868
8135,135,2025-05-01,27258,4518,31776
8136,136,2025-05-01,30201,864,31065
8137,137,2025-05-01,34527,200,34727
8138,138,2025-05-01,33808,2541,36349
8139,139,2025-05-01,29254,3961,33215
8140,140,2025-05-01,48708,1346,50054
8141,141,2025-05-01,12345,2746,15091
8142,142,2025-05-01,41646,90,41736
8143,143,2025-05-01,31504,2809,34313
8144,144,2025-05-01,27804,4208,32012
8145,145,2025-05-01,35393,2025,37418
8146,146,2025-05-01,33433,4862,38295
8147,147,2025-05-01,37331,3194,40525
8148,148,2025-05-01,48867,4264,53131
8149,149,2025-05-01,23430,2130,25560
8150,150,2025-05-01,28345,3573,31918
8151,151,2025-05-01,48322,1295,49617
8152,152,2025-05-01,28830,388,29218
8153,153,2025-05-01,28262,2247,30509
8154,154,2025-05-01,41432,514,41946
8155,155,2025-05-01,49716,2164,51880
8156,156,2025-05-01,45052,224,45276
8157,157,2025-05-01,48202,3282,51484
8158,158,2025-05-01,24032,4844,28876
8159,159,2025-05-01,19487,4095,23582
8160,160,2025-05-01,38740,3669,42409
8161,161,2025-05-01,39807,1754,41561
8162,162,2025-05-01,12201,2429,14630
8163,163,2025-05-01,29743,3553,33296
8164,164,2025-05-01,28203,3391,31594
8165,165,2025-05-01,22528,99,22627
8166,166,2025-05-01,39769,44,39813
8167,167,2025-05-01,17501,4478,21979
8168,168,2025-05-01,44443,971,45414
8169,169,2025-05-01,16956,2404,19360
8170,170,2025-05-01,29551,4537,34088
8171,171,2025-05-01,41849,4589,46438
8172,172,2025-05-01,34041,3574,37615
8173,173,2025-05-01,26059,1917,27976
8174,174,2025-05-01,30574,1880,32454
8175,175,2025-05-01,23914,520,24434
8176,176,2025-05-01,13583,4732,18315
8177,177,2025-05-01,44147,4419,48566
8178,178,2025-05-01,17330,-1928,15402
8179,179,2025-05-01,27585,602,28187
8180,180,2025-05-01,19489,4974,24463
8181,181,2025-05-01,10269,528,10797
8182,182,2025-05-01,34875,4234,39109
8183,183,2025-05-01,25210,3184,28394
8184,184,2025-05-01,26781,594,27375
8185,185,2025-05-01,11562,4544,16106
8186,186,2025-05-01,22534,4647,27181
8187,187,2025-05-01,26655,2851,29506
8188,188,2025-05-01,49967,1267,51234
8189,189,2025-05-01,17390,2130,19520
8190,190,2025-05-01,16156,3173,19329
8191,191,2025-05-01,26352,173,26525
8192,192,2025-05-01,26993,839,27832
8193,193,2025-05-01,33488,297,33785
8194,194,2025-05-01,15013,1132,16145
8195,195,2025-05-01,33532,2018,35550
8196,196,2025-05-01,31673,3556,35229
8197,197,2025-05-01,42188,2806,44994
8198,198,2025-05-01,44342,850,45192
8199,199,2025-05-01,30238,1576,31814
8200,200,2025-05-01,20831,2140,22971
8201,201,2025-05-01,23818,1267,25085
8202,202,2025-05-01,30263,1720,31983
8203,203,2025-05-01,18002,2714,20716
8204,204,2025-05-01,13930,920,14850
8205,205,2025-05-01,38251,2728,40979
8206,206,2025-05-01,39132,3018,42150
8207,207,2025-05-01,46536,972,47508
8208,208,2025-05-01,33561,3172,36733
8209,209,2025-05-01,27072,1753,28825
8210,210,2025-05-01,23453,3606,27059
8211,211,2025-05-01,38639,1900,40539
8212,212,2025-05-01,48553,359,48912
8213,213,2025-05-01,15011,4868,19879
8214,214,2025-05-01,18768,4998,23766
8215,215,2025-05-01,39071,2807,41878
8216,216,2025-05-01,39843,2755,42598
8217,217,2025-05-01,20192,1400,21592
8218,218,2025-05-01,39111,1160,40271
8219,219,2025-05-01,20844,3776,24620
8220,220,2025-05-01,28281,1124,29405
8221,221,2025-05-01,0,4889,4889
8222,222,2025-05-01,30344,4933,35277
8223,223,2025-05-01,42228,871,43099
8224,224,2025-05-01,20436,2525,22961
8225,225,2025-05-01,37282,4973,42255
8226,226,2025-05-01,49422,4087,53509
8227,227,2025-05-01,35307,3864,39171
8228,228,2025-05-01,34501,1677,36178
8229,229,2025-05-01,43006,260,43266
8230,230,2025-05-01,11422,456,11878
8231,231,2025-05-01,0,1919,1919
8232,232,2025-05-01,23301,2938,26239
8233,233,2025-05-01,21253,3696,24949
8234,234,2025-05-01,21037,4139,25176
8235,235,2025-05-01,25001,2571,27572
8236,236,2025-05-01,13132,3340,16472
8237,237,2025-05-01,34201,3593,37794
8238,238,2025-05-01,40749,2982,43731
8239,239,2025-05-01,15972,2226,18198
8240,240,2025-05-01,31362,281,31643
8241,241,2025-05-01,35501,2988,38489
8242,242,2025-05-01,12275,3239,15514
8243,243,2025-05-01,37715,4535,42250
8244,244,2025-05-01,34924,3404,38328
8245,245,2025-05-01,19418,1548,20966
8246,246,2025-05-01,33238,1197,34435
8247,247,2025-05-01,17946,987,18933
8248,248,2025-05-01,16222,3385,19607
8249,249,2025-05-01,16036,171,16207
8250,250,2025-05-01,38208,570,38778
8251,251,2025-05-01,32804,2100,34904
8252,252,2025-05-01,43683,2539,46222
8253,253,2025-05-01,38289,4365,42654
8254,254,2025-05-01,16558,111,16669
8255,255,2025-05-01,36499,4430,40929
8256,256,2025-05-01,35617,3182,38799
8257,257,2025-05-01,40496,2570,43066
8258,258,2025-05-01,38059,1711,39770
8259,259,2025-05-01,29144,-2,29142
8260,260,2025-05-01,27661,3538,31199
8261,261,2025-05-01,10550,2417,12967
8262,262,2025-05-01,10196,2105,12301
8263,263,2025-05-01,23726,4767,28493
8264,264,2025-05-01,40153,558,40711
8265,265,2025-05-01,47135,4026,51161
8266,266,2025-05-01,45355,3904,49259
8267,267,2025-05-01,20215,3199,23414
8268,268,2025-05-01,23356,2587,25943
8269,269,2025-05-01,30621,1179,31800
8270,270,2025-05-01,24515,121,24636
8271,271,2025-05-01,18570,1892,20462
8272,272,2025-05-01,35940,4651,40591
8273,273,2025-05-01,48915,3005,51920
8274,274,2025-05-01,10420,471,10891
8275,275,2025-05-01,38311,3918,42229
8276,276,2025-05-01,35820,4081,39901
8277,277,2025-05-01,21861,4196,26057
8278,278,2025-05-01,24099,54,24153
8279,279,2025-05-01,48852,3920,52772
8280,280,2025-05-01,44856,4096,48952
8281,281,2025-05-01,18236,254,18490
8282,282,2025-05-01,37337,-415,36922
8283,283,2025-05-01,28635,3265,31900
8284,284,2025-05-01,29191,2277,31468
8285,285,2025-05-01,32295,-732,31563
8286,286,2025-05-01,48134,2555,50689
8287,287,2025-05-01,36359,-3741,32618
8288,288,2025-05-01,33696,2406,36102
8289,289,2025-05-01,21930,2450,24380
8290,290,2025-05-01,20727,664,21391
8291,291,2025-05-01,32722,2456,35178
8292,292,2025-05-01,24411,4751,29162
8293,293,2025-05-01,10903,2770,13673
8294,294,2025-05-01,27485,1641,29126
8295,295,2025-05-01,36027,4030,40057
8296,296,2025-05-01,15790,1009,16799
8297,297,2025-05-01,27324,1955,29279
8298,298,2025-05-01,15499,2865,18364
8299,299,2025-05-01,40842,1368,42210
8300,300,2025-05-01,44185,2765,46950
8301,301,2025-05-01,11567,2331,13898
8302,302,2025-05-01,41684,2137,43821
8303,303,2025-05-01,47514,959,48473
8304,304,2025-05-01,26892,1072,27964
8305,305,2025-05-01,25168,2136,27304
8306,306,2025-05-01,22329,3101,25430
8307,307,2025-05-01,39448,3145,42593
8308,308,2025-05-01,27034,2471,29505
8309,309,2025-05-01,12910,4261,17171
8310,310,2025-05-01,21277,4901,26178
8311,311,2025-05-01,29391,2653,32044
8312,312,2025-05-01,28962,4369,33331
8313,313,2025-05-01,40849,1133,41982
8314,314,2025-05-01,47298,4513,51811
8315,315,2025-05-01,34249,4702,38951
8316,316,2025-05-01,22185,1159,23344
8317,317,2025-05-01,34158,3974,38132
8318,318,2025-05-01,24639,3987,28626
8319,319,2025-05-01,18947,-4950,13997
8320,320,2025-05-01,22437,3157,25594
8321,321,2025-05-01,47261,3630,50891
8322,322,2025-05-01,28558,4249,32807
8323,323,2025-05-01,16912,998,17910
8324,324,2025-05-01,16273,4067,20340
8325,325,2025-05-01,19467,295,19762
8326,326,2025-05-01,23439,4298,27737
8327,327,2025-05-01,26297,3808,30105
8328,328,2025-05-01,0,2199,2199
8329,329,2025-05-01,47617,2646,50263
8330,330,2025-05-01,12905,2759,15664
8331,331,2025-05-01,34781,4431,39212
8332,332,2025-05-01,34852,1229,36081
8333,333,2025-05-01,34553,-613,33940
8334,334,2025-05-01,14327,3699,18026
8335,335,2025-05-01,24095,3215,27310
8336,336,2025-05-01,14545,4612,19157
8337,337,2025-05-01,20469,1295,21764
8338,338,2025-05-01,39520,4873,44393
8339,339,2025-05-01,20265,1668,21933
8340,340,2025-05-01,17933,1518,19451
8341,341,2025-05-01,11102,4485,15587
8342,342,2025-05-01,45106,4387,49493
8343,343,2025-05-01,30550,4500,35050
8344,344,2025-05-01,35126,2601,37727
8345,345,2025-05-01,47206,3352,50558
8346,346,2025-05-01,14663,659,15322
8347,347,2025-05-01,16703,4368,21071
8348,348,2025-05-01,0,3630,3630
8349,349,2025-05-01,35460,1872,37332
8350,350,2025-05-01,32977,2680,35657
8351,351,2025-05-01,31388,406,31794
8352,352,2025-05-01,32948,3970,36918
8353,353,2025-05-01,38739,2117,40856
8354,354,2025-05-01,20050,2776,22826
8355,355,2025-05-01,19659,2843,22502
8356,356,2025-05-01,30665,768,31433
8357,357,2025-05-01,39536,1703,41239
8358,358,2025-05-01,42466,-636,41830
8359,359,2025-05-01,12156,893,13049
8360,360,2025-05-01,39971,4391,44362
8361,361,2025-05-01,41772,3200,44972
8362,362,2025-05-01,43564,1463,45027
8363,363,2025-05-01,39596,3407,43003
8364,364,2025-05-01,10092,4742,14834
8365,365,2025-05-01,22769,1428,24197
8366,366,2025-05-01,13996,2030,16026
8367,367,2025-05-01,27985,4292,32277
8368,368,2025-05-01,22360,2340,24700
8369,369,2025-05-01,11143,3733,14876
8370,370,2025-05-01,26810,328,27138
8371,371,2025-05-01,38707,4382,43089
8372,372,2025-05-01,27060,476,27536
8373,373,2025-05-01,19311,4124,23435
8374,374,2025-05-01,10761,1092,11853
8375,375,2025-05-01,16989,3108,20097
8376,376,2025-05-01,14947,4923,19870
8377,377,2025-05-01,28929,761,29690
8378,378,2025-05-01,36529,3173,39702
8379,379,2025-05-01,31361,1259,32620
8380,380,2025-05-01,14471,3355,17826
8381,381,2025-05-01,45529,3831,49360
8382,382,2025-05-01,26982,4089,31071
8383,383,2025-05-01,11482,210,11692
8384,384,2025-05-01,0,3222,3222
8385,385,2025-05-01,29932,2139,32071
8386,386,2025-05-01,42925,337,43262
8387,387,2025-05-01,28565,3714,32279
8388,388,2025-05-01,20271,4684,24955
8389,389,2025-05-01,46487,1984,48471
8390,390,2025-05-01,43515,-3206,40309
8391,391,2025-05-01,12991,794,13785
8392,392,2025-05-01,47858,1906,49764
8393,393,2025-05-01,31828,1522,33350
8394,394,2025-05-01,23050,3518,26568
8395,395,2025-05-01,46653,4814,51467
8396,396,2025-05-01,32478,2449,34927
8397,397,2025-05-01,23593,3886,27479
8398,398,2025-05-01,11769,2392,14161
8399,399,2025-05-01,34239,4750,38989
8400,400,2025-05-01,46345,1938,48283
8401,401,2025-05-01,34746,1463,36209
8402,402,2025-05-01,37654,963,38617
8403,403,2025-05-01,22465,1957,24422
8404,404,2025-05-01,35346,3554,38900
8405,405,2025-05-01,29341,4629,33970
8406,406,2025-05-01,28763,3619,32382
8407,407,2025-05-01,45576,2833,48409
8408,408,2025-05-01,23038,2281,25319
8409,409,2025-05-01,40392,29,40421
8410,410,2025-05-01,12273,2049,14322
8411,411,2025-05-01,46341,2955,49296
8412,412,2025-05-01,41238,43,41281
8413,413,2025-05-01,30473,427,30900
8414,414,2025-05-01,15263,3752,19015
8415,415,2025-05-01,47939,1976,49915
8416,416,2025-05-01,21764,1318,23082
8417,417,2025-05-01,27907,3476,31383
8418,418,2025-05-01,48063,-2838,45225
8419,419,2025-05-01,49396,2995,52391
8420,420,2025-05-01,43880,305,44185
8421,421,2025-05-01,14377,4948,19325
8422,422,2025-05-01,25036,233,25269
8423,423,2025-05-01,27889,2292,30181
8424,424,2025-05-01,48452,1967,50419
8425,425,2025-05-01,47828,3795,51623
8426,426,2025-05-01,46189,1360,47549
8427,427,2025-05-01,14687,1749,16436
8428,428,2025-05-01,18469,3192,21661
8429,429,2025-05-01,46589,455,47044
8430,430,2025-05-01,42311,561,42872
8431,431,2025-05-01,24503,4045,28548
8432,432,2025-05-01,30521,573,31094
8433,433,2025-05-01,24522,2536,27058
8434,434,2025-05-01,20539,760,21299
8435,435,2025-05-01,21696,4194,25890
8436,436,2025-05-01,49544,1548,51092
8437,437,2025-05-01,21302,815,22117
8438,438,2025-05-01,37309,1661,38970
8439,439,2025-05-01,23674,694,24368
8440,440,2025-05-01,22018,3470,25488
8441,441,2025-05-01,46190,4864,51054
8442,442,2025-05-01,39598,2135,41733
8443,443,2025-05-01,35502,1523,37025
8444,444,2025-05-01,29378,3168,32546
8445,445,2025-05-01,23099,957,24056
8446,446,2025-05-01,43607,402,44009
8447,447,2025-05-01,41033,4460,45493
8448,448,2025-05-01,12630,3495,16125
8449,449,2025-05-01,25084,3328,28412
8450,450,2025-05-01,32450,2217,34667
8451,451,2025-05-01,30558,207,30765
8452,452,2025-05-01,37737,3392,41129
8453,453,2025-05-01,27970,1172,29142
8454,454,2025-05-01,24865,2836,27701
8455,455,2025-05-01,25142,1306,26448
8456,456,2025-05-01,48847,2805,51652
8457,457,2025-05-01,20582,594,21176
8458,458,2025-05-01,43527,1715,45242
8459,459,2025-05-01,41352,2805,44157
8460,460,2025-05-01,47423,2112,49535
8461,461,2025-05-01,28056,675,28731
8462,462,2025-05-01,31866,4184,36050
8463,463,2025-05-01,31250,2475,33725
8464,464,2025-05-01,15169,4942,20111
8465,465,2025-05-01,17530,2696,20226
8466,466,2025-05-01,24277,1026,25303
8467,467,2025-05-01,46963,1250,48213
8468,468,2025-05-01,48651,2784,51435
8469,469,2025-05-01,48648,1093,49741
8470,470,2025-05-01,15819,-933,14886
8471,471,2025-05-01,13052,3577,16629
8472,472,2025-05-01,0,487,487
8473,473,2025-05-01,26238,3782,30020
8474,474,2025-05-01,16086,3966,20052
8475,475,2025-05-01,24371,4894,29265
8476,476,2025-05-01,20870,3334,24204
8477,477,2025-05-01,23311,3292,26603
8478,478,2025-05-01,37392,4054,41446
8479,479,2025-05-01,45700,4605,50305
8480,480,2025-05-01,34239,492,34731
8481,481,2025-05-01,15184,3483,18667
8482,482,2025-05-01,23277,3995,27272
8483,483,2025-05-01,33115,1191,34306
8484,484,2025-05-01,37502,2898,40400
8485,485,2025-05-01,33168,2750,35918
8486,486,2025-05-01,31386,370,31756
8487,487,2025-05-01,22163,176,22339
8488,488,2025-05-01,46150,1564,47714
8489,489,2025-05-01,10785,177,10962
8490,490,2025-05-01,15933,1392,17325
8491,491,2025-05-01,40692,639,41331
8492,492,2025-05-01,49817,4898,54715
8493,493,2025-05-01,38734,4154,42888
8494,494,2025-05-01,19105,2076,21181
8495,495,2025-05-01,27620,387,28007
8496,496,2025-05-01,11163,2969,14132
8497,497,2025-05-01,45504,2965,48469
8498,498,2025-05-01,40440,1235,41675
8499,499,2025-05-01,35879,2807,38686
8500,500,2025-05-01,32787,2194,34981
8501,1,2025-06-01,42326,2393,44719
8502,2,2025-06-01,29818,4129,33947
8503,3,2025-06-01,45465,4650,50115
8504,4,2025-06-01,15268,279,15547
8505,5,2025-06-01,26523,3518,30041
8506,6,2025-06-01,28853,4497,33350
8507,7,2025-06-01,40394,448,40842
8508,8,2025-06-01,48224,3658,51882
8509,9,2025-06-01,0,1955,1955
8510,10,2025-06-01,41966,3100,45066
8511,11,2025-06-01,24760,-522,24238
8512,12,2025-06-01,49806,4961,54767
8513,13,2025-06-01,18560,3731,22291
8514,14,2025-06-01,18985,4501,23486
8515,15,2025-06-01,33749,161,33910
8516,16,2025-06-01,0,2776,2776
8517,17,2025-06-01,39777,3790,43567
8518,18,2025-06-01,26721,1182,27903
8519,19,2025-06-01,42106,2633,44739
8520,20,2025-06-01,37385,1339,38724
8521,21,2025-06-01,45011,4731,49742
8522,22,2025-06-01,34673,4132,38805
8523,23,2025-06-01,20840,3340,24180
8524,24,2025-06-01,22461,-1370,21091
8525,25,2025-06-01,20612,51,20663
8526,26,2025-06-01,28788,2282,31070
8527,27,2025-06-01,12818,4254,17072
8528,28,2025-06-01,45985,1647,47632
8529,29,2025-06-01,13858,2822,16680
8530,30,2025-06-01,23565,2188,25753
8531,31,2025-06-01,40585,4936,45521
8532,32,2025-06-01,44534,4768,49302
8533,33,2025-06-01,12590,2955,15545
8534,34,2025-06-01,17372,3619,20991
8535,35,2025-06-01,29847,2001,31848
8536,36,2025-06-01,46564,2971,49535
8537,37,2025-06-01,37629,631,38260
8538,38,2025-06-01,0,4210,4210
8539,39,2025-06-01,36045,4680,40725
8540,40,2025-06-01,29821,3339,33160
8541,41,2025-06-01,28555,4071,32626
8542,42,2025-06-01,25338,1487,26825
8543,43,2025-06-01,13248,4489,17737
8544,44,2025-06-01,11407,4263,15670
8545,45,2025-06-01,45065,3125,48190
8546,46,2025-06-01,35540,3718,39258
8547,47,2025-06-01,20883,816,21699
8548,48,2025-06-01,27948,4036,31984
8549,49,2025-06-01,24642,4311,28953
8550,50,2025-06-01,25463,4489,29952
8551,51,2025-06-01,47205,851,48056
8552,52,2025-06-01,45124,1581,46705
8553,53,2025-06-01,15073,1705,16778
8554,54,2025-06-01,24366,1955,26321
8555,55,2025-06-01,24043,4608,28651
8556,56,2025-06-01,18215,2784,20999
8557,57,2025-06-01,35758,757,36515
8558,58,2025-06-01,28077,-2553,25524
8559,59,2025-06-01,14435,200,14635
8560,60,2025-06-01,29443,491,29934
8561,61,2025-06-01,21124,4522,25646
8562,62,2025-06-01,21786,261,22047
8563,63,2025-06-01,29626,944,30570
8564,64,2025-06-01,24244,4958,29202
8565,65,2025-06-01,20020,1866,21886
8566,66,2025-06-01,47586,3101,50687
8567,67,2025-06-01,10677,3732,14409
8568,68,2025-06-01,44521,3514,48035
8569,69,2025-06-01,36157,407,36564
8570,70,2025-06-01,18065,1511,19576
8571,71,2025-06-01,16753,1372,18125
8572,72,2025-06-01,20338,4656,24994
8573,73,2025-06-01,15775,916,16691
8574,74,2025-06-01,41110,4660,45770
8575,75,2025-06-01,47219,2072,49291
8576,76,2025-06-01,29700,1492,31192
8577,77,2025-06-01,38349,4816,43165
8578,78,2025-06-01,39722,3219,42941
8579,79,2025-06-01,0,3097,3097
8580,80,2025-06-01,17022,717,17739
8581,81,2025-06-01,39260,4920,44180
8582,82,2025-06-01,30587,3645,34232
8583,83,2025-06-01,48734,1296,50030
8584,84,2025-06-01,38596,4402,42998
8585,85,2025-06-01,41271,641,41912
8586,86,2025-06-01,17362,290,17652
8587,87,2025-06-01,22674,4613,27287
8588,88,2025-06-01,23227,4461,27688
8589,89,2025-06-01,0,3145,3145
8590,90,2025-06-01,0,4897,4897
8591,91,2025-06-01,16122,4780,20902
8592,92,2025-06-01,44229,764,44993
8593,93,2025-06-01,18670,2046,20716
8594,94,2025-06-01,34337,1647,35984
8595,95,2025-06-01,33225,487,33712
8596,96,2025-06-01,21822,3943,25765
8597,97,2025-06-01,22084,4950,27034
8598,98,2025-06-01,18503,868,19371
8599,99,2025-06-01,12248,2716,14964
8600,100,2025-06-01,36330,190,36520
8601,101,2025-06-01,13980,3832,17812
8602,102,2025-06-01,36877,3825,40702
8603,103,2025-06-01,27883,2774,30657
8604,104,2025-06-01,33742,4616,38358
8605,105,2025-06-01,13844,1704,15548
8606,106,2025-06-01,42216,3646,45862
8607,107,2025-06-01,23709,2460,26169
8608,108,2025-06-01,17099,1598,18697
8609,109,2025-06-01,34504,2621,37125
8610,110,2025-06-01,46856,1951,48807
8611,111,2025-06-01,43842,3846,47688
8612,112,2025-06-01,25736,1923,27659
8613,113,2025-06-01,22641,4591,27232
8614,114,2025-06-01,31220,4900,36120
8615,115,2025-06-01,42529,2707,45236
8616,116,2025-06-01,43820,455,44275
8617,117,2025-06-01,44206,1837,46043
8618,118,2025-06-01,14592,1424,16016
8619,119,2025-06-01,46453,2794,49247
8620,120,2025-06-01,12679,1087,13766
8621,121,2025-06-01,28122,3424,31546
8622,122,2025-06-01,26652,4123,30775
8623,123,2025-06-01,17810,365,18175
8624,124,2025-06-01,23471,3279,26750
8625,125,2025-06-01,39634,121,39755
8626,126,2025-06-01,43156,16,43172
8627,127,2025-06-01,36641,3438,40079
8628,128,2025-06-01,24435,2189,26624
8629,129,2025-06-01,20909,192,21101
8630,130,2025-06-01,35809,2385,38194
8631,131,2025-06-01,39381,4595,43976
8632,132,2025-06-01,28637,2690,31327
8633,133,2025-06-01,16761,4915,21676
8634,134,2025-06-01,11020,420,11440
8635,135,2025-06-01,21239,1764,23003
8636,136,2025-06-01,21601,737,22338
8637,137,2025-06-01,33410,2033,35443
8638,138,2025-06-01,16721,-4067,12654
8639,139,2025-06-01,48460,4649,53109
8640,140,2025-06-01,0,1981,1981
8641,141,2025-06-01,41625,4061,45686
8642,142,2025-06-01,30927,1223,32150
8643,143,2025-06-01,19287,3073,22360
8644,144,2025-06-01,18642,850,19492
8645,145,2025-06-01,34814,404,35218
8646,146,2025-06-01,19755,863,20618
8647,147,2025-06-01,44964,3031,47995
8648,148,2025-06-01,14491,2642,17133
8649,149,2025-06-01,24933,3133,28066
8650,150,2025-06-01,37047,3623,40670
8651,151,2025-06-01,23274,1585,24859
8652,152,2025-06-01,15366,1050,16416
8653,153,2025-06-01,36081,3725,39806
8654,154,2025-06-01,42176,4383,46559
8655,155,2025-06-01,21798,4567,26365
8656,156,2025-06-01,38596,4436,43032
8657,157,2025-06-01,39782,465,40247
8658,158,2025-06-01,20040,666,20706
8659,159,2025-06-01,24716,3443,28159
8660,160,2025-06-01,43803,2952,46755
8661,161,2025-06-01,30688,4889,35577
8662,162,2025-06-01,29123,514,29637
8663,163,2025-06-01,14353,2750,17103
8664,164,2025-06-01,42960,3404,46364
8665,165,2025-06-01,30254,2624,32878
8666,166,2025-06-01,18402,2353,20755
8667,167,2025-06-01,19396,601,19997
8668,168,2025-06-01,42458,114,42572
8669,169,2025-06-01,16817,1625,18442
8670,170,2025-06-01,21036,-3719,17317
8671,171,2025-06-01,39870,4950,44820
8672,172,2025-06-01,17414,4643,22057
8673,173,2025-06-01,11335,3262,14597
8674,174,2025-06-01,37002,247,37249
8675,175,2025-06-01,40147,4612,44759
8676,176,2025-06-01,22855,4691,27546
8677,177,2025-06-01,30396,3619,34015
8678,178,2025-06-01,13454,549,14003
8679,179,2025-06-01,18546,-4110,14436
8680,180,2025-06-01,49868,4785,54653
8681,181,2025-06-01,44038,-3730,40308
8682,182,2025-06-01,39170,-2818,36352
8683,183,2025-06-01,34119,1255,35374
8684,184,2025-06-01,16682,4802,21484
8685,185,2025-06-01,32600,1988,34588
8686,186,2025-06-01,19105,166,19271
8687,187,2025-06-01,10387,3328,13715
8688,188,2025-06-01,31355,1225,32580
8689,189,2025-06-01,14752,253,15005
8690,190,2025-06-01,23332,4146,27478
8691,191,2025-06-01,13202,841,14043
8692,192,2025-06-01,21312,4793,26105
8693,193,2025-06-01,32544,4585,37129
8694,194,2025-06-01,23267,2057,25324
8695,195,2025-06-01,16372,4082,20454
8696,196,2025-06-01,18323,1524,19847
8697,197,2025-06-01,14369,3172,17541
8698,198,2025-06-01,36433,4107,40540
8699,199,2025-06-01,19204,1228,20432
8700,200,2025-06-01,23048,2510,25558
8701,201,2025-06-01,46337,1480,47817
8702,202,2025-06-01,27175,1034,28209
8703,203,2025-06-01,15138,3947,19085
8704,204,2025-06-01,27267,1786,29053
8705,205,2025-06-01,40349,2249,42598
8706,206,2025-06-01,31639,2564,34203
8707,207,2025-06-01,16143,3023,19166
8708,208,2025-06-01,29718,1803,31521
8709,209,2025-06-01,34447,1314,35761
8710,210,2025-06-01,44438,3438,47876
8711,211,2025-06-01,22547,2546,25093
8712,212,2025-06-01,35248,1156,36404
8713,213,2025-06-01,34814,4487,39301
8714,214,2025-06-01,38302,2781,41083
8715,215,2025-06-01,34639,2906,37545
8716,216,2025-06-01,45961,4376,50337
8717,217,2025-06-01,47079,2999,50078
8718,218,2025-06-01,26903,1881,28784
8719,219,2025-06-01,19852,1620,21472
8720,220,2025-06-01,35119,3684,38803
8721,221,2025-06-01,47496,2593,50089
8722,222,2025-06-01,16773,4565,21338
8723,223,2025-06-01,30860,4057,34917
8724,224,2025-06-01,42490,123,42613
8725,225,2025-06-01,29341,3788,33129
8726,226,2025-06-01,20344,4473,24817
8727,227,2025-06-01,45125,2198,47323
8728,228,2025-06-01,47827,3385,51212
8729,229,2025-06-01,19646,1798,21444
8730,230,2025-06-01,39759,1301,41060
8731,231,2025-06-01,28934,682,29616
8732,232,2025-06-01,16280,3605,19885
8733,233,2025-06-01,27602,3153,30755
8734,234,2025-06-01,20428,4640,25068
8735,235,2025-06-01,18691,908,19599
8736,236,2025-06-01,43026,3252,46278
8737,237,2025-06-01,19017,1442,20459
8738,238,2025-06-01,48373,3355,51728
8739,239,2025-06-01,45968,3881,49849
8740,240,2025-06-01,16630,3903,20533
8741,241,2025-06-01,24718,1746,26464
8742,242,2025-06-01,38885,3450,42335
8743,243,2025-06-01,19940,1476,21416
8744,244,2025-06-01,45092,2341,47433
8745,245,2025-06-01,27227,2539,29766
8746,246,2025-06-01,28625,3637,32262
8747,247,2025-06-01,34766,3902,38668
8748,248,2025-06-01,36074,1654,37728
8749,249,2025-06-01,18593,2181,20774
8750,250,2025-06-01,11125,728,11853
8751,251,2025-06-01,14161,3439,17600
8752,252,2025-06-01,28425,292,28717
8753,253,2025-06-01,10170,2721,12891
8754,254,2025-06-01,29711,974,30685
8755,255,2025-06-01,31769,3445,35214
8756,256,2025-06-01,24503,4669,29172
8757,257,2025-06-01,13872,1043,14915
8758,258,2025-06-01,37732,4281,42013
8759,259,2025-06-01,10779,4317,15096
8760,260,2025-06-01,37423,783,38206
8761,261,2025-06-01,49232,3626,52858
8762,262,2025-06-01,46073,2706,48779
8763,263,2025-06-01,13468,3871,17339
8764,264,2025-06-01,18000,2052,20052
8765,265,2025-06-01,43022,4049,47071
8766,266,2025-06-01,27578,1235,28813
8767,267,2025-06-01,27525,3648,31173
8768,268,2025-06-01,38172,3225,41397
8769,269,2025-06-01,18651,510,19161
8770,270,2025-06-01,37545,2417,39962
8771,271,2025-06-01,15117,147,15264
8772,272,2025-06-01,45137,1623,46760
8773,273,2025-06-01,43989,666,44655
8774,274,2025-06-01,43516,-2480,41036
8775,275,2025-06-01,21489,2316,23805
8776,276,2025-06-01,27081,-1337,25744
8777,277,2025-06-01,11218,1820,13038
8778,278,2025-06-01,13772,3525,17297
8779,279,2025-06-01,13507,2849,16356
8780,280,2025-06-01,25189,1397,26586
8781,281,2025-06-01,11777,255,12032
8782,282,2025-06-01,18395,2538,20933
8783,283,2025-06-01,17861,2942,20803
8784,284,2025-06-01,18046,3635,21681
8785,285,2025-06-01,26022,550,26572
8786,286,2025-06-01,30706,981,31687
8787,287,2025-06-01,37790,2241,40031
8788,288,2025-06-01,36272,638,36910
8789,289,2025-06-01,17372,3088,20460
8790,290,2025-06-01,30078,4883,34961
8791,291,2025-06-01,41960,2916,44876
8792,292,2025-06-01,49121,1024,50145
8793,293,2025-06-01,20213,711,20924
8794,294,2025-06-01,24316,1744,26060
8795,295,2025-06-01,28949,1779,30728
8796,296,2025-06-01,43897,3437,47334
8797,297,2025-06-01,31625,1964,33589
8798,298,2025-06-01,16054,4523,20577
8799,299,2025-06-01,27291,1184,28475
8800,300,2025-06-01,19072,3874,22946
8801,301,2025-06-01,39337,1084,40421
8802,302,2025-06-01,49026,4174,53200
8803,303,2025-06-01,11847,3452,15299
8804,304,2025-06-01,18853,439,19292
8805,305,2025-06-01,49133,3877,53010
8806,306,2025-06-01,21927,501,22428
8807,307,2025-06-01,15146,4043,19189
8808,308,2025-06-01,48712,-2063,46649
8809,309,2025-06-01,34166,2269,36435
8810,310,2025-06-01,48077,246,48323
8811,311,2025-06-01,40480,6,40486
8812,312,2025-06-01,13647,4717,18364
8813,313,2025-06-01,23162,1700,24862
8814,314,2025-06-01,17910,782,18692
8815,315,2025-06-01,14941,2316,17257
8816,316,2025-06-01,22509,699,23208
8817,317,2025-06-01,33287,1386,34673
8818,318,2025-06-01,11871,4130,16001
8819,319,2025-06-01,25195,4844,30039
8820,320,2025-06-01,21729,2304,24033
8821,321,2025-06-01,13821,4392,18213
8822,322,2025-06-01,49190,1738,50928
8823,323,2025-06-01,23493,1600,25093
8824,324,2025-06-01,46898,2542,49440
8825,325,2025-06-01,23118,2905,26023
8826,326,2025-06-01,13144,80,13224
8827,327,2025-06-01,27999,677,28676
8828,328,2025-06-01,18142,1247,19389
8829,329,2025-06-01,16550,2576,19126
8830,330,2025-06-01,38635,3207,41842
8831,331,2025-06-01,26059,3865,29924
8832,332,2025-06-01,26852,1327,28179
8833,333,2025-06-01,37093,2640,39733
8834,334,2025-06-01,24509,3268,27777
8835,335,2025-06-01,0,1226,1226
8836,336,2025-06-01,39267,928,40195
8837,337,2025-06-01,12035,2096,14131
8838,338,2025-06-01,10036,4916,14952
8839,339,2025-06-01,22103,3445,25548
8840,340,2025-06-01,33526,2362,35888
8841,341,2025-06-01,23149,931,24080
8842,342,2025-06-01,27277,4457,31734
8843,343,2025-06-01,17160,2771,19931
8844,344,2025-06-01,44060,4008,48068
8845,345,2025-06-01,47787,853,48640
8846,346,2025-06-01,0,3933,3933
8847,347,2025-06-01,44243,4507,48750
8848,348,2025-06-01,25688,298,25986
8849,349,2025-06-01,0,2844,2844
8850,350,2025-06-01,40496,3322,43818
8851,351,2025-06-01,0,4234,4234
8852,352,2025-06-01,16021,758,16779
8853,353,2025-06-01,34178,2550,36728
8854,354,2025-06-01,45728,2789,48517
8855,355,2025-06-01,12423,4196,16619
8856,356,2025-06-01,41248,3206,44454
8857,357,2025-06-01,37244,2099,39343
8858,358,2025-06-01,28769,3447,32216
8859,359,2025-06-01,20623,4352,24975
8860,360,2025-06-01,34950,3896,38846
8861,361,2025-06-01,38527,2639,41166
8862,362,2025-06-01,28998,1220,30218
8863,363,2025-06-01,39595,115,39710
8864,364,2025-06-01,12693,3100,15793
8865,365,2025-06-01,17921,3957,21878
8866,366,2025-06-01,17127,661,17788
8867,367,2025-06-01,44193,2869,47062
8868,368,2025-06-01,38372,2137,40509
8869,369,2025-06-01,49261,2324,51585
8870,370,2025-06-01,37772,2854,40626
8871,371,2025-06-01,24316,4048,28364
8872,372,2025-06-01,28005,3164,31169
8873,373,2025-06-01,12131,1194,13325
8874,374,2025-06-01,42301,184,42485
8875,375,2025-06-01,30629,4299,34928
8876,376,2025-06-01,37166,1935,39101
8877,377,2025-06-01,31602,4440,36042
8878,378,2025-06-01,19530,1971,21501
8879,379,2025-06-01,36737,-3927,32810
8880,380,2025-06-01,29254,4827,34081
8881,381,2025-06-01,24801,764,25565
8882,382,2025-06-01,31206,3779,34985
8883,383,2025-06-01,46188,58,46246
8884,384,2025-06-01,29943,2124,32067
8885,385,2025-06-01,16119,2211,18330
8886,386,2025-06-01,39877,4782,44659
8887,387,2025-06-01,31880,1414,33294
8888,388,2025-06-01,33654,2221,35875
8889,389,2025-06-01,20202,4520,24722
8890,390,2025-06-01,40311,3378,43689
8891,391,2025-06-01,13030,3601,16631
8892,392,2025-06-01,21598,3522,25120
8893,393,2025-06-01,28869,1667,30536
8894,394,2025-06-01,19352,2133,21485
8895,395,2025-06-01,40648,4454,45102
8896,396,2025-06-01,39745,1311,41056
8897,397,2025-06-01,42196,2448,44644
8898,398,2025-06-01,46916,4325,51241
8899,399,2025-06-01,15195,1011,16206
8900,400,2025-06-01,36092,703,36795
8901,401,2025-06-01,48777,4622,53399
8902,402,2025-06-01,10593,2524,13117
8903,403,2025-06-01,35553,561,36114
8904,404,2025-06-01,20322,3532,23854
8905,405,2025-06-01,49446,1049,50495
8906,406,2025-06-01,10706,2898,13604
8907,407,2025-06-01,35213,3959,39172
8908,408,2025-06-01,42430,639,43069
8909,409,2025-06-01,35242,4642,39884
8910,410,2025-06-01,12077,4154,16231
8911,411,2025-06-01,41804,160,41964
8912,412,2025-06-01,20139,995,21134
8913,413,2025-06-01,47923,1267,49190
8914,414,2025-06-01,44855,-1387,43468
8915,415,2025-06-01,13774,3982,17756
8916,416,2025-06-01,36879,3978,40857
8917,417,2025-06-01,47463,1760,49223
8918,418,2025-06-01,37905,4670,42575
8919,419,2025-06-01,27153,662,27815
8920,420,2025-06-01,29728,4583,34311
8921,421,2025-06-01,25398,874,26272
8922,422,2025-06-01,46130,1116,47246
8923,423,2025-06-01,12659,4319,16978
8924,424,2025-06-01,46440,-794,45646
8925,425,2025-06-01,28636,2993,31629
8926,426,2025-06-01,41084,3750,44834
8927,427,2025-06-01,32600,3223,35823
8928,428,2025-06-01,13331,157,13488
8929,429,2025-06-01,44824,2440,47264
8930,430,2025-06-01,29712,1157,30869
8931,431,2025-06-01,36164,912,37076
8932,432,2025-06-01,38648,977,39625
8933,433,2025-06-01,24240,3257,27497
8934,434,2025-06-01,12380,3105,15485
8935,435,2025-06-01,43946,2399,46345
8936,436,2025-06-01,30549,905,31454
8937,437,2025-06-01,23387,4586,27973
8938,438,2025-06-01,0,4742,4742
8939,439,2025-06-01,39715,1697,41412
8940,440,2025-06-01,18047,3020,21067
8941,441,2025-06-01,27491,4949,32440
8942,442,2025-06-01,10342,308,10650
8943,443,2025-06-01,21009,2987,23996
8944,444,2025-06-01,33253,185,33438
8945,445,2025-06-01,16507,4860,21367
8946,446,2025-06-01,36104,3732,39836
8947,447,2025-06-01,10901,2752,13653
8948,448,2025-06-01,41316,4719,46035
8949,449,2025-06-01,11612,211,11823
8950,450,2025-06-01,36235,916,37151
8951,451,2025-06-01,35680,3286,38966
8952,452,2025-06-01,10217,735,10952
8953,453,2025-06-01,24190,1641,25831
8954,454,2025-06-01,11863,2161,14024
8955,455,2025-06-01,28572,4198,32770
8956,456,2025-06-01,20673,3376,24049
8957,457,2025-06-01,46465,4516,50981
8958,458,2025-06-01,24217,4536,28753
8959,459,2025-06-01,16395,4785,21180
8960,460,2025-06-01,22268,2959,25227
8961,461,2025-06-01,18388,1912,20300
8962,462,2025-06-01,17117,4468,21585
8963,463,2025-06-01,11620,1241,12861
8964,464,2025-06-01,20513,474,20987
8965,465,2025-06-01,14324,2779,17103
8966,466,2025-06-01,35783,802,36585
8967,467,2025-06-01,43652,2761,46413
8968,468,2025-06-01,38052,908,38960
8969,469,2025-06-01,41491,901,42392
8970,470,2025-06-01,31789,380,32169
8971,471,2025-06-01,38721,3827,42548
8972,472,2025-06-01,49792,4704,54496
8973,473,2025-06-01,26881,3199,30080
8974,474,2025-06-01,46621,1053,47674
8975,475,2025-06-01,36379,2531,38910
8976,476,2025-06-01,24968,2846,27814
8977,477,2025-06-01,39344,1525,40869
8978,478,2025-06-01,36189,4006,40195
8979,479,2025-06-01,18530,4338,22868
8980,480,2025-06-01,31781,3043,34824
8981,481,2025-06-01,36009,49,36058
8982,482,2025-06-01,46774,1273,48047
8983,483,2025-06-01,24479,396,24875
8984,484,2025-06-01,31607,1316,32923
8985,485,2025-06-01,16698,1823,18521
8986,486,2025-06-01,36340,3579,39919
8987,487,2025-06-01,20001,-3309,16692
8988,488,2025-06-01,24638,4512,29150
8989,489,2025-06-01,42497,886,43383
8990,490,2025-06-01,33362,4374,37736
8991,491,2025-06-01,27397,2779,30176
8992,492,2025-06-01,17776,3802,21578
8993,493,2025-06-01,44691,4652,49343
8994,494,2025-06-01,39444,438,39882
8995,495,2025-06-01,39577,1694,41271
8996,496,2025-06-01,11523,2276,13799
8997,497,2025-06-01,21485,429,21914
8998,498,2025-06-01,20965,4113,25078
8999,499,2025-06-01,42387,4204,46591
9000,500,2025-06-01,38631,4513,43144
9001,1,2025-07-01,33408,2834,36242
9002,2,2025-07-01,17369,1928,19297
9003,3,2025-07-01,11080,4285,15365
9004,4,2025-07-01,16932,1665,18597
9005,5,2025-07-01,26829,4807,31636
9006,6,2025-07-01,40413,2043,42456
9007,7,2025-07-01,15655,3661,19316
9008,8,2025-07-01,45102,244,45346
9009,9,2025-07-01,39950,1244,41194
9010,10,2025-07-01,22065,156,22221
9011,11,2025-07-01,32072,3380,35452
9012,12,2025-07-01,33764,-549,33215
9013,13,2025-07-01,37914,2766,40680
9014,14,2025-07-01,15936,1233,17169
9015,15,2025-07-01,49731,301,50032
9016,16,2025-07-01,48837,802,49639
9017,17,2025-07-01,40734,407,41141
9018,18,2025-07-01,42088,2813,44901
9019,19,2025-07-01,21123,3924,25047
9020,20,2025-07-01,24331,3842,28173
9021,21,2025-07-01,10553,1168,11721
9022,22,2025-07-01,39938,1296,41234
9023,23,2025-07-01,31669,1081,32750
9024,24,2025-07-01,38649,4202,42851
9025,25,2025-07-01,12438,1884,14322
9026,26,2025-07-01,18775,435,19210
9027,27,2025-07-01,33020,903,33923
9028,28,2025-07-01,42175,914,43089
9029,29,2025-07-01,18266,293,18559
9030,30,2025-07-01,25198,2403,27601
9031,31,2025-07-01,39496,4566,44062
9032,32,2025-07-01,44709,4998,49707
9033,33,2025-07-01,24475,-4607,19868
9034,34,2025-07-01,25040,1634,26674
9035,35,2025-07-01,33885,3614,37499
9036,36,2025-07-01,35861,4312,40173
9037,37,2025-07-01,36333,4167,40500
9038,38,2025-07-01,47250,2865,50115
9039,39,2025-07-01,40109,1045,41154
9040,40,2025-07-01,18432,3079,21511
9041,41,2025-07-01,19853,338,20191
9042,42,2025-07-01,43687,4245,47932
9043,43,2025-07-01,35887,2374,38261
9044,44,2025-07-01,37448,378,37826
9045,45,2025-07-01,24797,1599,26396
9046,46,2025-07-01,27166,3485,30651
9047,47,2025-07-01,26047,3196,29243
9048,48,2025-07-01,48466,-1914,46552
9049,49,2025-07-01,49606,1738,51344
9050,50,2025-07-01,32007,1100,33107
9051,51,2025-07-01,15832,585,16417
9052,52,2025-07-01,10363,2794,13157
9053,53,2025-07-01,43208,2225,45433
9054,54,2025-07-01,46541,1624,48165
9055,55,2025-07-01,34044,1774,35818
9056,56,2025-07-01,20663,3996,24659
9057,57,2025-07-01,43897,2323,46220
9058,58,2025-07-01,45049,441,45490
9059,59,2025-07-01,46588,4067,50655
9060,60,2025-07-01,12062,3547,15609
9061,61,2025-07-01,32413,1934,34347
9062,62,2025-07-01,21424,1595,23019
9063,63,2025-07-01,24975,2423,27398
9064,64,2025-07-01,26160,3915,30075
9065,65,2025-07-01,23224,614,23838
9066,66,2025-07-01,11643,4637,16280
9067,67,2025-07-01,37436,2108,39544
9068,68,2025-07-01,36967,3610,40577
9069,69,2025-07-01,21153,3994,25147
9070,70,2025-07-01,25035,4957,29992
9071,71,2025-07-01,11286,2888,14174
9072,72,2025-07-01,14960,39,14999
9073,73,2025-07-01,26830,3166,29996
9074,74,2025-07-01,49784,1400,51184
9075,75,2025-07-01,13582,3212,16794
9076,76,2025-07-01,15464,1922,17386
9077,77,2025-07-01,41104,2974,44078
9078,78,2025-07-01,24299,2483,26782
9079,79,2025-07-01,13747,1882,15629
9080,80,2025-07-01,15111,4437,19548
9081,81,2025-07-01,14332,-2485,11847
9082,82,2025-07-01,34792,315,35107
9083,83,2025-07-01,41996,1342,43338
9084,84,2025-07-01,42163,3270,45433
9085,85,2025-07-01,29259,4012,33271
9086,86,2025-07-01,22283,-777,21506
9087,87,2025-07-01,16085,2264,18349
9088,88,2025-07-01,34401,-1479,32922
9089,89,2025-07-01,27429,4702,32131
9090,90,2025-07-01,30629,-854,29775
9091,91,2025-07-01,30328,3959,34287
9092,92,2025-07-01,13698,1933,15631
9093,93,2025-07-01,20520,4804,25324
9094,94,2025-07-01,23893,1401,25294
9095,95,2025-07-01,27580,4762,32342
9096,96,2025-07-01,35529,2695,38224
9097,97,2025-07-01,34630,3847,38477
9098,98,2025-07-01,42809,1153,43962
9099,99,2025-07-01,24919,1797,26716
9100,100,2025-07-01,48061,4622,52683
9101,101,2025-07-01,10689,3016,13705
9102,102,2025-07-01,11837,520,12357
9103,103,2025-07-01,12374,4360,16734
9104,104,2025-07-01,27404,4822,32226
9105,105,2025-07-01,48147,3088,51235
9106,106,2025-07-01,49166,2157,51323
9107,107,2025-07-01,12175,2555,14730
9108,108,2025-07-01,30626,914,31540
9109,109,2025-07-01,45129,4747,49876
9110,110,2025-07-01,22338,3943,26281
9111,111,2025-07-01,28439,3240,31679
9112,112,2025-07-01,11494,2709,14203
9113,113,2025-07-01,43257,3978,47235
9114,114,2025-07-01,21923,2089,24012
9115,115,2025-07-01,12248,4382,16630
9116,116,2025-07-01,19660,3696,23356
9117,117,2025-07-01,17303,184,17487
9118,118,2025-07-01,41347,1945,43292
9119,119,2025-07-01,32463,621,33084
9120,120,2025-07-01,15763,3674,19437
9121,121,2025-07-01,44374,4683,49057
9122,122,2025-07-01,49250,519,49769
9123,123,2025-07-01,39952,1354,41306
9124,124,2025-07-01,40184,469,40653
9125,125,2025-07-01,11065,2970,14035
9126,126,2025-07-01,0,1568,1568
9127,127,2025-07-01,40718,1339,42057
9128,128,2025-07-01,36608,2503,39111
9129,129,2025-07-01,29856,988,30844
9130,130,2025-07-01,29196,293,29489
9131,131,2025-07-01,46108,2879,48987
9132,132,2025-07-01,20140,4955,25095
9133,133,2025-07-01,26550,1048,27598
9134,134,2025-07-01,13795,3440,17235
9135,135,2025-07-01,45930,1407,47337
9136,136,2025-07-01,21039,3802,24841
9137,137,2025-07-01,23680,3215,26895
9138,138,2025-07-01,40013,3469,43482
9139,139,2025-07-01,28336,2500,30836
9140,140,2025-07-01,24324,3459,27783
9141,141,2025-07-01,0,2798,2798
9142,142,2025-07-01,29012,3376,32388
9143,143,2025-07-01,44645,3902,48547
9144,144,2025-07-01,23012,3729,26741
9145,145,2025-07-01,10073,4794,14867
9146,146,2025-07-01,46426,1987,48413
9147,147,2025-07-01,44269,1916,46185
9148,148,2025-07-01,27714,598,28312
9149,149,2025-07-01,16796,4500,21296
9150,150,2025-07-01,38294,1847,40141
9151,151,2025-07-01,11661,4276,15937
9152,152,2025-07-01,21920,4276,26196
9153,153,2025-07-01,11368,2208,13576
9154,154,2025-07-01,32160,4098,36258
9155,155,2025-07-01,34850,149,34999
9156,156,2025-07-01,31802,155,31957
9157,157,2025-07-01,28173,2054,30227
9158,158,2025-07-01,18589,3601,22190
9159,159,2025-07-01,38540,809,39349
9160,160,2025-07-01,35196,77,35273
9161,161,2025-07-01,29617,4325,33942
9162,162,2025-07-01,15405,4206,19611
9163,163,2025-07-01,25208,1180,26388
9164,164,2025-07-01,45882,2173,48055
9165,165,2025-07-01,39398,4847,44245
9166,166,2025-07-01,43760,4116,47876
9167,167,2025-07-01,23057,1107,24164
9168,168,2025-07-01,34676,4760,39436
9169,169,2025-07-01,41198,1321,42519
9170,170,2025-07-01,47253,2332,49585
9171,171,2025-07-01,40722,2684,43406
9172,172,2025-07-01,17895,1483,19378
9173,173,2025-07-01,23312,4220,27532
9174,174,2025-07-01,36622,3771,40393
9175,175,2025-07-01,18817,4234,23051
9176,176,2025-07-01,37263,273,37536
9177,177,2025-07-01,18601,3222,21823
9178,178,2025-07-01,49136,41,49177
9179,179,2025-07-01,29846,4102,33948
9180,180,2025-07-01,35644,2101,37745
9181,181,2025-07-01,30155,4688,34843
9182,182,2025-07-01,17625,3674,21299
9183,183,2025-07-01,32425,2193,34618
9184,184,2025-07-01,14846,2431,17277
9185,185,2025-07-01,24969,3432,28401
9186,186,2025-07-01,17589,4345,21934
9187,187,2025-07-01,24357,4264,28621
9188,188,2025-07-01,16716,2183,18899
9189,189,2025-07-01,20048,1031,21079
9190,190,2025-07-01,22706,761,23467
9191,191,2025-07-01,20704,4613,25317
9192,192,2025-07-01,47696,1513,49209
9193,193,2025-07-01,49399,1723,51122
9194,194,2025-07-01,32652,4285,36937
9195,195,2025-07-01,49120,2490,51610
9196,196,2025-07-01,26728,4997,31725
9197,197,2025-07-01,16250,1934,18184
9198,198,2025-07-01,38447,3601,42048
9199,199,2025-07-01,26307,583,26890
9200,200,2025-07-01,23856,2906,26762
9201,201,2025-07-01,14960,3468,18428
9202,202,2025-07-01,37324,4595,41919
9203,203,2025-07-01,39988,2845,42833
9204,204,2025-07-01,39681,796,40477
9205,205,2025-07-01,21891,863,22754
9206,206,2025-07-01,25872,1461,27333
9207,207,2025-07-01,29964,2531,32495
9208,208,2025-07-01,15018,966,15984
9209,209,2025-07-01,47680,1832,49512
9210,210,2025-07-01,40212,81,40293
9211,211,2025-07-01,26444,3388,29832
9212,212,2025-07-01,31439,360,31799
9213,213,2025-07-01,39564,3290,42854
9214,214,2025-07-01,29485,2077,31562
9215,215,2025-07-01,14919,411,15330
9216,216,2025-07-01,43713,3076,46789
9217,217,2025-07-01,45572,4666,50238
9218,218,2025-07-01,23394,4261,27655
9219,219,2025-07-01,12399,2236,14635
9220,220,2025-07-01,18896,1583,20479
9221,221,2025-07-01,15144,4294,19438
9222,222,2025-07-01,24529,4460,28989
9223,223,2025-07-01,42559,4842,47401
9224,224,2025-07-01,44292,4446,48738
9225,225,2025-07-01,34509,3998,38507
9226,226,2025-07-01,17733,4294,22027
9227,227,2025-07-01,41716,3066,44782
9228,228,2025-07-01,15081,1263,16344
9229,229,2025-07-01,43237,1342,44579
9230,230,2025-07-01,18700,3273,21973
9231,231,2025-07-01,36035,2713,38748
9232,232,2025-07-01,0,1921,1921
9233,233,2025-07-01,30537,4871,35408
9234,234,2025-07-01,37584,504,38088
9235,235,2025-07-01,42235,4622,46857
9236,236,2025-07-01,29672,2926,32598
9237,237,2025-07-01,45664,2458,48122
9238,238,2025-07-01,42433,3963,46396
9239,239,2025-07-01,49477,3837,53314
9240,240,2025-07-01,45242,863,46105
9241,241,2025-07-01,42346,-3797,38549
9242,242,2025-07-01,18086,479,18565
9243,243,2025-07-01,23727,4476,28203
9244,244,2025-07-01,47537,-4504,43033
9245,245,2025-07-01,44313,1587,45900
9246,246,2025-07-01,36171,4614,40785
9247,247,2025-07-01,45601,952,46553
9248,248,2025-07-01,15458,3533,18991
9249,249,2025-07-01,12397,3722,16119
9250,250,2025-07-01,40613,1004,41617
9251,251,2025-07-01,25185,3698,28883
9252,252,2025-07-01,21307,3872,25179
9253,253,2025-07-01,27974,304,28278
9254,254,2025-07-01,36285,1374,37659
9255,255,2025-07-01,48122,903,49025
9256,256,2025-07-01,16063,1002,17065
9257,257,2025-07-01,35662,593,36255
9258,258,2025-07-01,16039,4639,20678
9259,259,2025-07-01,17057,635,17692
9260,260,2025-07-01,14359,3122,17481
9261,261,2025-07-01,0,3550,3550
9262,262,2025-07-01,11103,2287,13390
9263,263,2025-07-01,24528,1065,25593
9264,264,2025-07-01,28596,407,29003
9265,265,2025-07-01,44482,4206,48688
9266,266,2025-07-01,32543,664,33207
9267,267,2025-07-01,22593,177,22770
9268,268,2025-07-01,28480,2363,30843
9269,269,2025-07-01,17391,4103,21494
9270,270,2025-07-01,49796,3505,53301
9271,271,2025-07-01,39700,179,39879
9272,272,2025-07-01,19096,1014,20110
9273,273,2025-07-01,18365,1708,20073
9274,274,2025-07-01,23450,4728,28178
9275,275,2025-07-01,20384,3444,23828
9276,276,2025-07-01,20480,4882,25362
9277,277,2025-07-01,33978,158,34136
9278,278,2025-07-01,14735,1053,15788
9279,279,2025-07-01,19118,3669,22787
9280,280,2025-07-01,44198,338,44536
9281,281,2025-07-01,25710,864,26574
9282,282,2025-07-01,30962,4133,35095
9283,283,2025-07-01,15005,-1456,13549
9284,284,2025-07-01,25298,1073,26371
9285,285,2025-07-01,30261,2774,33035
9286,286,2025-07-01,30306,409,30715
9287,287,2025-07-01,39621,1616,41237
9288,288,2025-07-01,23910,4686,28596
9289,289,2025-07-01,10280,2149,12429
9290,290,2025-07-01,0,1707,1707
9291,291,2025-07-01,26280,1722,28002
9292,292,2025-07-01,39354,2480,41834
9293,293,2025-07-01,23147,2581,25728
9294,294,2025-07-01,44223,1962,46185
9295,295,2025-07-01,44401,4967,49368
9296,296,2025-07-01,0,2761,2761
9297,297,2025-07-01,18106,1165,19271
9298,298,2025-07-01,18410,3362,21772
9299,299,2025-07-01,39695,4972,44667
9300,300,2025-07-01,19935,85,20020
9301,301,2025-07-01,10760,240,11000
9302,302,2025-07-01,25680,2893,28573
9303,303,2025-07-01,24333,1996,26329
9304,304,2025-07-01,38978,1674,40652
9305,305,2025-07-01,30189,2051,32240
9306,306,2025-07-01,26309,694,27003
9307,307,2025-07-01,12284,1156,13440
9308,308,2025-07-01,14986,2207,17193
9309,309,2025-07-01,12239,4973,17212
9310,310,2025-07-01,44151,2553,46704
9311,311,2025-07-01,44043,2415,46458
9312,312,2025-07-01,21272,460,21732
9313,313,2025-07-01,48381,-3064,45317
9314,314,2025-07-01,23590,2462,26052
9315,315,2025-07-01,32801,4621,37422
9316,316,2025-07-01,37215,1040,38255
9317,317,2025-07-01,28290,4252,32542
9318,318,2025-07-01,16150,4073,20223
9319,319,2025-07-01,44558,4601,49159
9320,320,2025-07-01,13417,424,13841
9321,321,2025-07-01,33475,2308,35783
9322,322,2025-07-01,44745,618,45363
9323,323,2025-07-01,38167,769,38936
9324,324,2025-07-01,14454,4606,19060
9325,325,2025-07-01,34897,3137,38034
9326,326,2025-07-01,38245,2891,41136
9327,327,2025-07-01,49120,3402,52522
9328,328,2025-07-01,29772,3078,32850
9329,329,2025-07-01,23492,2069,25561
9330,330,2025-07-01,42057,3668,45725
9331,331,2025-07-01,18199,2388,20587
9332,332,2025-07-01,12152,3576,15728
9333,333,2025-07-01,39908,-3192,36716
9334,334,2025-07-01,30953,4224,35177
9335,335,2025-07-01,32618,3808,36426
9336,336,2025-07-01,41551,2790,44341
9337,337,2025-07-01,33276,763,34039
9338,338,2025-07-01,18700,4529,23229
9339,339,2025-07-01,14675,-111,14564
9340,340,2025-07-01,17245,1283,18528
9341,341,2025-07-01,33700,4315,38015
9342,342,2025-07-01,34581,-698,33883
9343,343,2025-07-01,0,7,7
9344,344,2025-07-01,15767,3049,18816
9345,345,2025-07-01,12853,744,13597
9346,346,2025-07-01,35511,3090,38601
9347,347,2025-07-01,28004,4606,32610
9348,348,2025-07-01,44696,4226,48922
9349,349,2025-07-01,37436,875,38311
9350,350,2025-07-01,44585,2506,47091
9351,351,2025-07-01,38050,913,38963
9352,352,2025-07-01,20553,4934,25487
9353,353,2025-07-01,41062,2570,43632
9354,354,2025-07-01,21489,2403,23892
9355,355,2025-07-01,42881,141,43022
9356,356,2025-07-01,40975,1534,42509
9357,357,2025-07-01,32386,958,33344
9358,358,2025-07-01,27941,556,28497
9359,359,2025-07-01,32191,1560,33751
9360,360,2025-07-01,22910,2803,25713
9361,361,2025-07-01,36510,2529,39039
9362,362,2025-07-01,21060,3000,24060
9363,363,2025-07-01,29239,2149,31388
9364,364,2025-07-01,36765,-4364,32401
9365,365,2025-07-01,21232,1750,22982
9366,366,2025-07-01,49703,1462,51165
9367,367,2025-07-01,34160,13,34173
9368,368,2025-07-01,37536,1017,38553
9369,369,2025-07-01,12649,684,13333
9370,370,2025-07-01,11724,2173,13897
9371,371,2025-07-01,13187,1443,14630
9372,372,2025-07-01,35911,3080,38991
9373,373,2025-07-01,25789,4653,30442
9374,374,2025-07-01,31172,1853,33025
9375,375,2025-07-01,21208,2511,23719
9376,376,2025-07-01,39905,4544,44449
9377,377,2025-07-01,20904,4752,25656
9378,378,2025-07-01,25968,2269,28237
9379,379,2025-07-01,13475,4649,18124
9380,380,2025-07-01,39044,389,39433
9381,381,2025-07-01,26323,3626,29949
9382,382,2025-07-01,49693,4005,53698
9383,383,2025-07-01,42647,2714,45361
9384,384,2025-07-01,48617,2490,51107
9385,385,2025-07-01,19734,4094,23828
9386,386,2025-07-01,35262,4330,39592
9387,387,2025-07-01,19774,3587,23361
9388,388,2025-07-01,47270,4543,51813
9389,389,2025-07-01,36635,2637,39272
9390,390,2025-07-01,40361,1097,41458
9391,391,2025-07-01,30442,1039,31481
9392,392,2025-07-01,39196,2824,42020
9393,393,2025-07-01,33000,1171,34171
9394,394,2025-07-01,45902,179,46081
9395,395,2025-07-01,32228,2315,34543
9396,396,2025-07-01,15339,2092,17431
9397,397,2025-07-01,29480,-3881,25599
9398,398,2025-07-01,33014,3333,36347
9399,399,2025-07-01,32335,12,32347
9400,400,2025-07-01,39189,340,39529
9401,401,2025-07-01,45143,1852,46995
9402,402,2025-07-01,0,4376,4376
9403,403,2025-07-01,29230,2149,31379
9404,404,2025-07-01,17405,287,17692
9405,405,2025-07-01,37665,3092,40757
9406,406,2025-07-01,40508,92,40600
9407,407,2025-07-01,37738,2271,40009
9408,408,2025-07-01,19763,3252,23015
9409,409,2025-07-01,17993,1346,19339
9410,410,2025-07-01,49784,2283,52067
9411,411,2025-07-01,21970,4611,26581
9412,412,2025-07-01,38943,240,39183
9413,413,2025-07-01,21017,1,21018
9414,414,2025-07-01,0,2037,2037
9415,415,2025-07-01,45216,3899,49115
9416,416,2025-07-01,37830,1171,39001
9417,417,2025-07-01,49474,933,50407
9418,418,2025-07-01,49571,1347,50918
9419,419,2025-07-01,36925,4839,41764
9420,420,2025-07-01,40317,1958,42275
9421,421,2025-07-01,19103,3959,23062
9422,422,2025-07-01,31251,1017,32268
9423,423,2025-07-01,36016,1222,37238
9424,424,2025-07-01,35796,3142,38938
9425,425,2025-07-01,14468,432,14900
9426,426,2025-07-01,11645,2608,14253
9427,427,2025-07-01,10067,969,11036
9428,428,2025-07-01,21017,3407,24424
9429,429,2025-07-01,22862,4013,26875
9430,430,2025-07-01,39119,4673,43792
9431,431,2025-07-01,13465,243,13708
9432,432,2025-07-01,40117,252,40369
9433,433,2025-07-01,35955,4398,40353
9434,434,2025-07-01,37874,3152,41026
9435,435,2025-07-01,30285,3394,33679
9436,436,2025-07-01,10882,1079,11961
9437,437,2025-07-01,21204,1428,22632
9438,438,2025-07-01,37798,3547,41345
9439,439,2025-07-01,21225,196,21421
9440,440,2025-07-01,17899,2535,20434
9441,441,2025-07-01,47560,347,47907
9442,442,2025-07-01,23582,1750,25332
9443,443,2025-07-01,14507,72,14579
9444,444,2025-07-01,35925,-978,34947
9445,445,2025-07-01,29133,1127,30260
9446,446,2025-07-01,14321,703,15024
9447,447,2025-07-01,25661,4095,29756
9448,448,2025-07-01,43022,3191,46213
9449,449,2025-07-01,33518,3505,37023
9450,450,2025-07-01,45597,-245,45352
9451,451,2025-07-01,34978,4823,39801
9452,452,2025-07-01,35248,2585,37833
9453,453,2025-07-01,34214,4172,38386
9454,454,2025-07-01,47204,2178,49382
9455,455,2025-07-01,29710,2730,32440
9456,456,2025-07-01,42901,85,42986
9457,457,2025-07-01,39951,2647,42598
9458,458,2025-07-01,34996,3719,38715
9459,459,2025-07-01,37031,2719,39750
9460,460,2025-07-01,37556,4544,42100
9461,461,2025-07-01,29021,4234,33255
9462,462,2025-07-01,40343,2993,43336
9463,463,2025-07-01,36308,2098,38406
9464,464,2025-07-01,40162,46,40208
9465,465,2025-07-01,12183,367,12550
9466,466,2025-07-01,38686,2793,41479
9467,467,2025-07-01,16162,1003,17165
9468,468,2025-07-01,28535,1314,29849
9469,469,2025-07-01,33604,3899,37503
9470,470,2025-07-01,13792,4537,18329
9471,471,2025-07-01,13515,3618,17133
9472,472,2025-07-01,46635,3234,49869
9473,473,2025-07-01,48346,-159,48187
9474,474,2025-07-01,30019,4065,34084
9475,475,2025-07-01,38986,1387,40373
9476,476,2025-07-01,42040,3478,45518
9477,477,2025-07-01,26511,3298,29809
9478,478,2025-07-01,25674,1735,27409
9479,479,2025-07-01,20463,2362,22825
9480,480,2025-07-01,48633,3261,51894
9481,481,2025-07-01,28211,1208,29419
9482,482,2025-07-01,21955,2372,24327
9483,483,2025-07-01,40327,2650,42977
9484,484,2025-07-01,27885,3996,31881
9485,485,2025-07-01,31528,3821,35349
9486,486,2025-07-01,23137,671,23808
9487,487,2025-07-01,24848,1833,26681
9488,488,2025-07-01,17253,2107,19360
9489,489,2025-07-01,14546,1587,16133
9490,490,2025-07-01,45588,2548,48136
9491,491,2025-07-01,14946,4243,19189
9492,492,2025-07-01,34332,1304,35636
9493,493,2025-07-01,40775,1185,41960
9494,494,2025-07-01,44970,2735,47705
9495,495,2025-07-01,11771,4474,16245
9496,496,2025-07-01,34998,4224,39222
9497,497,2025-07-01,16373,4813,21186
9498,498,2025-07-01,14820,4534,19354
9499,499,2025-07-01,21666,3747,25413
9500,500,2025-07-01,37915,336,38251
